question	answer
1.1投保范围	投保范围1.被保险人范围：凡出生满28天至60周岁（详见释义），身体健康且符合我们规定的投保条件者均可作为被保险人参加本保险。2.投保人范围：被保险人本人或对被保险人有保险利益的其他人可作为投保人向本公司投保本保险。
1.2合同构成	合同构成本保险合同（以下简称本合同）由保险单或其他保险凭证及所附条款、投保单、与本合同有关的其他投保文件、健康告知书、保险合同变更申请书、声明、批注、附贴批单及其他书面协议构成。
1.3合同成立与生效	合同成立您提出保险申请、本公司同意承保，本合同成立，合同成立日期在保险单上载明。与生效除另有约定外，自本合同成立、本公司收取首期保险费并签发保险单的次日零时起本合同生效，本公司开始承担保险责任，合同生效日期在保险单上载明。本合同生效日即为保单生效日。
1.4犹豫期	犹豫期本合同生效后，本公司为您提供10日的犹豫期，犹豫期指您收到保险单并书面签收之日起10日的期间，您在上述期间内要求解除本合同的，应书面提出合同解除申请，并提供您的保险合同及有效身份证件，本公司将在扣除不超过10元的保单工本费后退还本保险交纳的保险费。自本公司收到合同解除申请之日起，本合同即被解除，对本合同解除前发生的保险事故本公司不承担保险责任。
1.5合同内容变更	合同内容您和本公司可以协商变更本合同的有关内容。变更本合同的，由本公司在保险单变更或其他保险凭证上批注或附贴批单，或由您和本公司订立变更的书面协议。
1.6您解除合同的手续及风险	您解除合您在犹豫期后要求解除本合同的，应书面提出合同解除申请，并提供下列证明和同的手续资料：及风险1.保险合同；2.您的有效身份证件。自本公司收到合同解除申请及上述证明和资料之日起，本合同终止。本公司自收到解除合同申请之日起30日内向您退还保险单的现金价值（详见释义）。您犹豫期后解除合同可能会遭受一定损失。如已发生保险金给付的，您不得要求解除本合同。
1.7合同终止	合同终止以下任何一种情况发生时，本合同终止：1.在本合同有效期内解除本合同的；2.本公司已经履行完毕保险责任的；3.本合同因条款所列其他情况而终止的。我们提供的保障
2.1基本保险金额	基本保险本合同基本保险金额由您和本公司在投保时约定，但须符合本公司当时的投保规金额定，约定的基本保险金额将在保险单上载明。为未成年子女投保的，因被保险人身故给付的保险金总和不得超过国务院保险监督管理机构规定的限额，身故保险金总和的约定也不得超过前述限额。
2.2保险期间	保险期间本合同的保险期间为被保险人终身，并在保险单上载明。保险期间自本合同生效日的零时开始。
2.3保险责任	保险责任在本合同保险期间内，本公司承担下列保险责任：
2.3.1轻症疾病保险金	轻症疾病被保险人于本合同生效（或合同效力恢复）之日起90日后，由本公司认可医院保险金（详见释义）的专科医生（详见释义）确诊初次发生（详见释义）本合同所指的轻症疾病（详见释义）（无论一种或多种），本公司按本合同基本保险金额的一定给付比例给付轻症疾病保险金，本合同继续有效：若被保险人被确诊的轻症疾病是以其在本合同保险期间内遭受的意外伤害（详见释义）为直接且单独的原因所致，则不受前述90日的限制。每种轻症疾病只给付一次轻症疾病保险金，给付后该种轻症疾病的保险责任终止。本合同轻症疾病保险金的累计给付次数以四次为限。如果被保险人由于同一疾病原因、同次医疗行为或同次意外伤害事故，确诊初次发生本合同所指的两种或者两种以上的轻症疾病，我们仅按一种轻症疾病给付轻症疾病保险金。若被保险人确诊的疾病同时符合本合同所指的轻症疾病定义和本合同所指的中症疾病（详见释义）定义的，我们仅承担给付中症疾病保险金的保险责任。若被保险人确诊的疾病同时符合本合同所指的轻症疾病定义和本合同所指的重大疾病（详见释义）定义的，我们仅承担给付重大疾病保险金的保险责任。
2.3.2中症疾病保险金	中症疾病被保险人于本合同生效（或合同效力恢复）之日起90日后，由本公司认可医院保险金的专科医生确诊初次发生本合同所指的中症疾病（无论一种或多种），本公司按本合同基本保险金额的50给付中症疾病保险金，本合同继续有效。若被保险人被确诊的中症疾病是以其在本合同保险期间内遭受的意外伤害为直接且单独的原因所致，则不受前述90日的限制。每种中症疾病只给付一次中症疾病保险金，给付后该种中症疾病的保险责任终止。本合同中症疾病保险金的累计给付次数以两次为限。如果被保险人由于同一疾病原因、同次医疗行为或同次意外伤害事故，确诊初次发生本合同所指的两种或者两种以上的中症疾病，我们仅按一种中症疾病给付中症疾病保险金。若被保险人确诊的疾病同时符合本合同所指的中症疾病定义和本合同所指的重大疾病定义的，我们仅承担给付重大疾病保险金的保险责任。
2.3.3住院关爱津贴保险金	住院关爱被保险人于本合同生效（或合同效力恢复）之日起90日后且自其年满60周岁后（含60周岁）在本公司认可医院住院（详见释义）治疗的，本公司按本合同基本保津贴保险金险金额的0.1乘以实际住院天数（详见释义）给付住院关爱津贴保险金。同一个保单年度（详见释义）内，被保险人无论一次或多次住院治疗，本公司的累计给付天数以90日为限；本合同保险期间内累计给付的住院关爱津贴保险金达到本合同基本保险金额时，该项保险责任终止，本合同继续有效。如被保险人已领取了住院关爱津贴保险金的，本公司在给付首次重大疾病保险金、疾病终末期保险金或身故保险金时，均需扣减已累计给付的住院关爱津贴保险金。若被保险人住院治疗是以其在本合同保险期间内遭受的意外伤害为直接且单独的原因所致，则不受前述90日的限制。
2.3.4重大疾病保险金	重大疾病本合同所指的重大疾病分为A、B、C、D、E、F六组，具体疾病分组信息请见重保险金大疾病分组（详见释义）。每组重大疾病保险金的给付次数以一次为限，给付后该组重大疾病的保险责任终止。本合同重大疾病保险金的累计给付次数以六次为限，当累计给付达到六次时，本合同终止。如果被保险人由于同一疾病原因、同次医疗行为或同次意外伤害事故，确诊初次发生本合同所指的两种或者两种以上的重大疾病，我们仅按一种重大疾病给付重大疾病保险金。
2.3.4.1首次重大疾病保险金	首次重大被保险人于本合同生效（或合同效力恢复）之日起90日内，由本公司认可医院的专科医生确诊初次发生本合同所指的重大疾病（无论一种或多种），本公司按本保疾病保险金险实际交纳的保险费（详见释义）给付首次重大疾病保险金，本合同终止。被保险人于本合同生效（或合同效力恢复）之日起90日后，由本公司认可医院的专科医生确诊初次发生本合同所指的重大疾病（无论一种或多种），本公司按以下三者之较大者给付首次重大疾病保险金，该重大疾病所属组别的保险责任以及2.3.1轻症疾病保险金、2.3.2中症疾病保险金、2.3.3住院关爱津贴保险金、2.3.5疾病终末期保险金、2.3.6身故保险金的保险责任均终止，我们将继续承担其他组别重大疾病保险金的保险责任：1.本保险实际交纳的保险费；2.首次重大疾病确诊之日时本合同的现金价值；3.本合同基本保险金额的100。若被保险人被确诊的重大疾病是以其在本合同保险期间内遭受的意外伤害为直接且单独的原因所致，则不受前述90日的限制。我们给付首次重大疾病保险金后，本合同自首次重大疾病确诊之日起现金价值降为零。
2.3.4.2第二次重大疾病保险金	第二次重我们给付首次重大疾病保险金后，被保险人于首次重大疾病确诊之日起180日大疾病保后，由本公司认可医院的专科医生确诊初次发生本合同所指的重大疾病中除首次重大险金疾病所属组别以外的其他组别中的重大疾病（无论一种或多种），本公司按本合同基本保险金额的110给付第二次重大疾病保险金，该重大疾病所属组别的保险责任终止。
2.3.4.3第三次重大疾病保险金	第三次重我们给付第二次重大疾病保险金后，被保险人于第二次重大疾病确诊之日起180大疾病保日后，由本公司认可医院的专科医生确诊初次发生本合同所指的重大疾病中除前述二险金次重大疾病所属组别以外的其他组别中的重大疾病（无论一种或多种），本公司按本合同基本保险金额的120给付第三次重大疾病保险金，该重大疾病所属组别的保险责任终止。
2.3.4.4第四次重大疾病保险金	第四次重我们给付第三次重大疾病保险金后，被保险人于第三次重大疾病确诊之日起180大疾病保日后，由本公司认可医院的专科医生确诊初次发生本合同所指的重大疾病中除前述三险金次重大疾病所属组别以外的其他组别中的重大疾病（无论一种或多种），本公司按本合同基本保险金额的130给付第四次重大疾病保险金，该重大疾病所属组别的保险责任终止。
2.3.4.5第五次重大疾病保险金	第五次重我们给付第四次重大疾病保险金后，被保险人于第四次重大疾病确诊之日起180大疾病保日后，由本公司认可医院的专科医生确诊初次发生本合同所指的重大疾病中除前述四险金次重大疾病所属组别以外的其他组别中的重大疾病（无论一种或多种），本公司按本合同基本保险金额的140给付第五次重大疾病保险金，该重大疾病所属组别的保险责任终止。
2.3.4.6第六次重大疾病保险金	第六次重我们给付第五次重大疾病保险金后，被保险人于第五次重大疾病确诊之日起180大疾病保日后，由本公司认可医院的专科医生确诊初次发生本合同所指的重大疾病中除前述五险金次重大疾病所属组别以外的其他组别中的重大疾病（无论一种或多种），本公司按本合同基本保险金额的150给付第六次重大疾病保险金，本合同终止。
2.3.5疾病终末期保险金	疾病终末被保险人于本合同生效（或合同效力恢复）之日起90日内，由本公司认可医院期保险金的专科医生确诊初次达到疾病终末期阶段（详见释义），本公司按本保险实际交纳的保险费给付疾病终末期保险金，本合同终止。被保险人于本合同生效（或合同效力恢复）之日起90日后，由本公司认可医院的专科医生确诊初次达到疾病终末期阶段，本公司按以下约定给付疾病终末期保险金，本合同终止：1.被保险人于18周岁保单生效对应日（详见释义）之前达到疾病终末期阶段，本公司按本保险实际交纳的保险费200给付疾病终末期保险金；2.被保险人于18周岁保单生效对应日后达到疾病终末期阶段，本公司按以下三者之较大者给付疾病终末期保险金：（1）本保险实际交纳的保险费；（2）达到疾病终末期阶段时本合同的现金价值；（3）本合同基本保险金额的100。若被保险人被确诊初次达到疾病终末期阶段是以其在本合同保险期间内遭受的意外伤害为直接且单独的原因所致，则不受前述90日的限制。
2.3.6身故保险金	被保险人于本合同生效（或合同效力恢复）之日起90日内身故，本公司按本保身故保险金险实际交纳的保险费给付身故保险金，本合同终止。被保险人于本合同生效（或合同效力恢复）之日起90日后身故，本公司按以下约定给付身故保险金，本合同终止：1.被保险人于18周岁保单生效对应日之前身故，本公司按本保险实际交纳的保险费200给付身故保险金；2.被保险人于18周岁保单生效对应日后身故，本公司按以下三者之较大者给付身故保险金：（1）本保险实际交纳的保险费；（2）身故时本合同的现金价值；（3）本合同基本保险金额的100。若被保险人身故是以其在本合同保险期间内遭受的意外伤害为直接且单独的原因所致，则不受前述90日的限制。前述2.3.4重大疾病保险金、2.3.5疾病终末期保险金、2.3.6身故保险金三者不可兼得，即若本公司给付其中任何一项保险金，则其余两项保险金将不再给付。
2.3.7轻症疾病或中症疾病豁免保险费	轻症疾病被保险人于本合同生效（或合同效力恢复）之日起90日后，由本公司认可医院或中症疾的专科医生确诊初次发生本合同所指的轻症疾病或本合同所指的中症疾病，我们将豁病豁免保免本合同自轻症疾病或中症疾病确诊之日起的续期保险费，本合同继续有效。险费若被保险人被确诊的轻症疾病或中症疾病是以其在本合同保险期间内遭受的意外伤害为直接且单独的原因所致，则不受前述90日的限制。
2.3.8重大疾病豁免保险费	重大疾病被保险人于本合同生效（或合同效力恢复）之日起90日后，由本公司认可医院的专科医生确诊初次发生本合同所指的重大疾病，我们将豁免本合同自重大疾病确诊豁免保险费之日起的续期保险费，本合同继续有效。若被保险人被确诊的重大疾病是以其在本合同保险期间内遭受的意外伤害为直接且单独的原因所致，则不受前述90日的限制。
2.4责任免除	责任免除被保险人因下列第17项情形之一身故的，本公司不承担保险责任；被保险人因下列第210项情形之一发生本合同所指的重大疾病、轻症疾病、中症疾病、达到疾病终末期阶段或住院治疗的，本公司不承担保险责任：1.自本合同成立（或合同效力恢复）之日起二年内自杀，但自杀时为无民事行为能力人的除外；2.投保人对被保险人的故意杀害、故意伤害；3.故意犯罪或抗拒依法采取的刑事强制措施；4.主动吸食或注射毒品（详见释义）；5.酒后驾驶（详见释义）、无合法有效驾驶证驾驶（详见释义）或驾驶无有效行驶证（详见释义）的机动车（详见释义）；6.战争、军事冲突、暴乱或武装叛乱；7.核爆炸、核辐射或核污染；8.故意自伤；9.遗传性疾病（详见释义），先天性畸形、变形或染色体异常（详见释义）；10.感染艾滋病病毒或患艾滋病(详见释义)。被保险人因上述第2项情形身故的，本合同终止，本公司向被保险人的继承人退还保险单的现金价值。被保险人因上述第2项情形发生重大疾病、轻症疾病、中症疾病、达到疾病终末期阶段或住院治疗的，本合同终止，本公司向被保险人退还保险单的现金价值。被保险人因上述第1项、第37项情形之一身故的，本合同终止，本公司向您退还保险单的现金价值。被保险人因上述第310项情形之一发生重大疾病、轻症疾病、中症疾病、达到疾病终末期阶段或住院治疗的，本合同终止，本公司向您退还保险单的现金价值。您的权利和义务
3.1保险费的交纳	保险费的本合同保险费的交费方式和交费期间由您和本公司约定，但须符合本公司当时的交纳投保规定，约定的交费方式和交费期间将在保险单上载明。
3.2续期保险费的交纳、宽限期	续期保险本合同续期保险费应按保险单所载明的交费方式和交费日期交纳，您应该在所选费的交择的交费期间内每年交纳保险费，交纳保险费的具体日期为当年的保单生效对应日，并在保险单上载明。如到期未交纳，自保险单所载明的交费日期的次日零时起60日纳、宽限期为宽限期。宽限期内发生保险事故的，本公司承担保险责任，但在给付保险金时将扣减您欠交的保险费。
3.3合同效力中止	合同效力除另有约定外，您逾宽限期仍未交纳续期保险费的，本合同自宽限期满的次日零中止时起效力中止。本合同效力中止期间发生保险事故的，本公司不承担保险责任。
3.4合同效力恢复	合同效力本合同效力中止后二年内，您可以申请恢复本合同效力。经本公司与您协商并达恢复成协议，自您补交保险费及利息之日起，本合同效力恢复。前述补交保险费的利息按保单质押贷款利率计算。自本合同效力中止之日起满二年双方未达成复效协议的，本公司有权解除本合同，并退还宽限期开始前一日保险单的现金价值。
3.5减保	减保本合同已交足二年以上保险费且生效二年后，您可以申请减保，但减保后的基本保险金额不得低于申请减保时本公司规定的最低标准。减保后，基本保险金额同比例减少，同时，您将领取减少部分对应的现金价值。减保后的保险费按下列公式计算：减保后的保险费本次减保前的保险费(1减保比例)本公司按减保后的基本保险金额承担保险责任。
3.6保单质押贷款	保单质押在本合同有效期内，经被保险人书面同意，您可凭保险单向本公司申请保单质押贷款贷款。经本公司同意，贷款金额以贷款时现金价值净额的80为限，每次贷款期限不得超过六个月。贷款利息在贷款到期时应与本金一并归还，逾期不还者，贷款本息与其他各项欠款达到保险单的现金价值全数时，本合同终止。上述所称现金价值净额指保险单的现金价值扣除其他欠款后的余额。保单质押贷款利率参照同期中国人民银行六个月期贷款利率并结合本公司自身资金成本及风险管控能力确定并公布，公布时间分别为每年的一月一日和七月一日。
3.7年金转换选择	年金转换在本合同有效期内，经被保险人书面同意，您可于被保险人年满66周岁起的任一选择保单生效对应日将保险单的现金价值的部分或全部转换为年金保险，但用于转换的现金价值不得低于本公司当时所规定的最低限额，对年金保险转换部分本公司不再承担本合同所规定的保险责任。本公司将按转换时您选择的转换年金保险所约定的领取方式，向被保险人分期支付年金。具体领取金额或领取年限等事宜将在转换年金保险合同中约定。您需在拟申请年金转换的保单生效对应日之前至少提前30日向本公司书面提出转换年金申请。
3.8保险费自动垫交	保险费自您在投保时选择保险费自动垫交方式的，若续期保险费超过宽限期仍未交纳，且动垫交此时本合同现金价值扣除未还款项及其利息后的余额足以垫交当期保险费，本公司将以本合同现金价值扣除未还款项及其利息后的余额自动垫交应交纳的保险费，本合同继续有效。垫交的保险费视作您从本公司的保单质押贷款。若本合同现金价值扣除未还款项及其利息后的余额不足以垫交当期保险费，本合同效力自宽限期满的次日零时起中止。保险金的申请与给付
4.1保险金受益人的指定和变更	保险金受轻症疾病保险金、中症疾病保险金、住院关爱津贴保险金、重大疾病保险金、疾益人的指病终末期保险金受益人为被保险人本人。定和变更您或被保险人可指定一人或数人为身故保险金受益人，受益人为数人时，应确定受益顺序和受益份额，未确定受益份额的，各受益人按相等份额享有受益权。被保险人为无民事行为能力人或限制民事行为能力人的，可以由其监护人指定受益人。您或被保险人可以变更身故保险金受益人，但须书面通知本公司，由本公司在保险单或其他保险凭证上批注或附贴批单。您在指定和变更身故保险金受益人时，须经被保险人书面同意。为与您有劳动关系的劳动者投保，不得指定被保险人及其近亲属以外的人为受益人。被保险人身故后，有下列情形之一的，身故保险金作为被保险人的遗产，由本公司依照中华人民共和国继承法的规定履行给付保险金的义务：1.没有指定受益人或受益人指定不明无法确定的；2.受益人先于被保险人身故，没有其他受益人的；3.受益人依法丧失受益权或放弃受益权，没有其他受益人的。被保险人和受益人在同一事件中身故，无法确定两者身故先后顺序的，推定受益人先于被保险人身故。受益人故意造成被保险人身故、伤残、疾病的，或故意杀害被保险人未遂的，该受益人丧失受益权。
4.2保险事故通知	保险事故您、被保险人或受益人应在知道保险事故发生之日起10日内通知本公司。通知如您、被保险人或受益人故意或因重大过失未及时通知本公司，致使保险事故的性质、原因、损失程度等难以确定的，本公司对无法确定的部分，不承担给付保险金的责任，但本公司通过其他途径已经及时知道或应当及时知道保险事故发生，或虽未及时通知但不影响本公司确定保险事故的性质、原因、损失程度的除外。
4.3保险金及豁免保险费的申请	保险金及1.申请轻症疾病保险金、中症疾病保险金、重大疾病保险金、疾病终末期保险金、豁免保险轻症疾病或中症疾病豁免保险费、重大疾病豁免保险费时，由被保险人作为申请人书费的申请面提出保险金给付及豁免保险费申请，并提供下列证明和资料：（1）保险合同；（2）被保险人的有效身份证件；（3）本公司认可医院出具的附有病历、必要病理检验、血液检验及其他科学方法检验报告的疾病诊断书；（4）所能提供的与确认保险事故的性质、原因、伤害程度等有关的其他证明和资料。2.申请住院关爱津贴保险金时，由被保险人作为申请人填写保险金给付申请书，并提供下列证明和资料：（1）保险合同；（2）被保险人的有效身份证件；（3）本公司认可医院出具的出院小结或住院病历（加盖医院病历专用章）、住院发票复印件和费用明细清单；（4）所能提供的与确认保险事故的性质、原因、伤害程度等有关的其他证明和资料。3.申请身故保险金时，由受益人或其他有权领取保险金的人作为申请人书面提出保险金给付申请，并提供下列证明和资料：（1）保险合同；（2）申请人的有效身份证件；（3）国家卫生行政部门认定的医疗机构、公安部门或其他相关机构出具的被保险人的死亡证明；（4）所能提供的与确认保险事故的性质、原因、伤害程度等有关的其他证明和资料。保险金作为被保险人遗产时，须提供可证明合法继承权的相关权利文件。4.如委托他人代为申请，还须填写索赔申请书（含资料调阅授权书）委托栏，并提供受托人有效身份证件。5.本公司认为有关证明和资料不完整的，将及时一次性通知申请人补充提供。
4.4保险金的给付	保险金的本公司在收到保险金给付申请及上述有关证明和资料后，将在5日内作出核定；给付情形复杂的，在30日内作出核定。对属于保险责任的，本公司在与被保险人或受益人达成有关给付保险金数额的协议后10日内，履行给付保险金义务。本公司未及时履行前款规定义务的，将赔偿被保险人或受益人因此受到的损失。前述损失是指根据中国人民银行公布的同时期的人民币活期存款基准利率计算的利息损失。对不属于保险责任的，本公司自作出核定之日起3日内向申请人发出拒绝给付保险金通知书，并说明理由。本公司在收到保险金给付申请及有关证明和资料之日起60日内，对给付保险金的数额不能确定的，根据已有证明和资料可以确定的数额先予支付；本公司最终确定给付保险金的数额后，将支付相应的差额。
4.5未还款项的扣除	未还款项本公司在办理给付保险金、退还保险单的现金价值或退还本保险实际交纳的保险的扣除费等事项时，如您有欠交保险费、保单质押贷款或其他款项未还清的，本公司先扣除欠交保险费、保单质押贷款及其他款项后，再办理相关手续。
4.6诉讼时效	诉讼时效受益人向本公司请求给付身故保险金的诉讼时效期间为5年，自其知道或者应当知道保险事故发生之日起计算。受益人向本公司请求给付其他保险金的诉讼时效期间为2年，自其知道或者应当知道保险事故发生之日起计算。其他需要关注的事项
5.1明确说明与如实告知	明确说明订立本合同时，本公司会向您明确说明本合同的条款内容。对本合同中免除本公司责任的条款，本公司在订立合同时将在投保单、保险单或其他保险凭证上作出足以与如实告知引起您注意的提示，并对该条款的内容以书面或口头形式向您作出明确说明，未作提示或明确说明的，该免除本公司责任条款不产生效力。本公司会就您和被保险人的有关情况提出书面询问，您应当如实告知。您故意或因重大过失未履行如实告知义务，足以影响本公司决定是否同意承保或提高保险费率的，本公司有权解除本合同。您故意不履行如实告知义务，对于本合同解除前发生的保险事故，本公司不承担保险责任，并不退还本保险实际交纳的保险费。您因重大过失未履行如实告知义务，对保险事故的发生有严重影响的，对于本合同解除前发生的保险事故，本公司不承担保险责任，但将退还本保险实际交纳的保险费。本公司在合同订立时已经知道您未如实告知的情况的，本公司不得解除合同；发生保险事故的，本公司承担给付保险金的责任。
5.2本公司合同解除权的限制	本公司合前条规定的合同解除权，自本公司知道有解除事由之日起，超过30日不行使而同解除权消灭。自本合同成立之日起超过二年的，本公司不得解除本合同；发生保险事故的，的限制本公司承担给付保险金的责任。
5.3年龄确定与错误处理	年龄确定1.被保险人的年龄以周岁计算。2.您在申请投保时，应将与有效身份证件相符的被保险人的出生日期在投保单上与错误处理填明，如发生错误按下列方式办理：（1）您申报的被保险人年龄不真实，并且其真实年龄不符合本合同约定投保年龄限制的，本公司有权解除合同，并向您退还保险单的现金价值。本公司行使合同解除权适用前条本公司合同解除权的限制的规定。（2）您申报的被保险人年龄不真实，致使您实付保险费少于应付保险费的，本公司有权更正并要求您补交保险费；如已经发生保险事故的，在给付保险金时按实付保险费和应付保险费的比例支付。（3）您申报的被保险人年龄不真实，致使您实付保险费多于应付保险费的，本公司会将多收的保险费退还给您。
5.4地址变更	地址变更为了保障您的合法权益，您的住所或通讯地址变更时，请及时通知本公司。如您未通知本公司，本公司按本合同载明的最后住所或通讯地址发送的有关通知，均视为已送达给您。
5.5失踪处理	失踪处理被保险人在本合同保险期间内失踪，并经人民法院宣告死亡，本公司依据人民法院的宣告死亡判决及宣告死亡日，按本合同规定给付保险金。如日后被保险人重新出现或确知其没有死亡，保险金领取人应将已领取的保险金于被保险人重新出现或确知其没有死亡之日起30日内退还本公司，本合同的效力由您和本公司依法协商处理。
5.6争议处理	争议处理本合同争议解决方式由当事人约定从下列二种方式中选择一种：1.因履行本合同发生的争议，由当事人协商解决，协商不成的，提交双方共同选择的仲裁委员会仲裁；2.因履行本合同发生的争议，由当事人协商解决，协商不成的，依法向人民法院起诉。
释义	
6.1周岁	周岁以法定有效身份证件中记载的出生日期为计算基础，自出生之日起为零周岁，每经过一年增加一岁，不足一年的不计。
6.2现金价值	现金价值指保险单所具有的价值，通常体现为解除合同时，根据精算原理计算的，由本公司退还的那部分金额。保单年度末的现金价值金额在现金价值表上载明，保单年度之内的现金价值金额您可以向我们查询。保单年度：从保单生效日或保单生效对应日零时起至下一年度保单生效对应日零时止为一个保单年度。
6.3认可医院	认可医院指二级及以上非盈利性医院、二级及以上社保定点医院或本公司认可的其他医院。具体可咨询本公司全国客户服务电话或登陆本公司主页（www.tiananlife.com）查询。
6.4专科医生	专科医生专科医生应当同时满足以下四项资格条件：1.具有有效的中华人民共和国医师资格证书；2.具有有效的中华人民共和国医师执业证书，并按期到相关部门登记注册；3.具有有效的中华人民共和国主治医师或主治医师以上职称的医师职称证书；4.在二级或二级以上医院的相应科室从事临床工作三年以上。
6.5初次发生	初次发生指被保险人初次出现与约定疾病相关的症状或体征，而该症状或体征已足以引起一般人士注意并去医院寻求医疗检查，且被诊断为约定的疾病或在其后发展为约定的疾病。
6.6本合同所指的轻症疾病	本合同所本合同所指的轻症疾病(共35种，我公司对6.6.2不典型心肌梗塞、6.6.3指的轻症微创冠状动脉搭桥手术和6.6.4微创冠状动脉介入手术仅承担其中一种疾病的疾病轻症疾病保险金责任)，是指符合下列定义的疾病、疾病状态或手术：
6.6.1极早期恶性肿瘤或恶性病变	极早期恶指经组织病理学检查被明确诊断为下列恶性病变，并且接受了相应的治疗。性肿瘤或1.原位癌；恶性病变2.相当于Binet分期方案A期程度的慢性淋巴细胞白血病；3.相当于AnnArbor分期方案期程度的何杰金氏病；4.皮肤癌（不包括恶性黑色素瘤及已发生转移的皮肤癌）；5.TNM分期为TNM期或更轻分期的前列腺癌。原位癌：指恶性细胞局限于上皮内尚未穿破基底膜浸润周围正常组织的癌细胞新生物。原位癌必须经对固定活组织的组织病理学检查明确诊断。被保险人必须已经接受了针对原位癌病灶的积极治疗。
6.6.2不典型心肌梗塞	不典型心指被临床诊断为急性心肌梗塞并接受了急性心肌梗塞治疗，虽然未达到本合同所肌梗塞指的重大疾病6.9.2急性心肌梗塞的给付标准，但满足下列全部条件：1.肌钙蛋白有诊断意义的升高；2.心电图有损伤性的ST段改变但未出现病理Q波。本公司对该种轻症疾病理赔后，不再对6.6.3微创冠状动脉搭桥手术、6.6.4微创冠状动脉介入手术承担给付轻症疾病保险金的责任。
6.6.3微创冠状动脉搭桥手术	微创冠状指为纠正冠状动脉的狭窄或堵塞，而实际实施的微创冠状动脉旁路移植手术。手动脉搭桥术通过微创开胸术（肋骨间小切口）进行，且诊断须由冠状动脉血管造影检查确诊狭手术窄或堵塞。微创冠状动脉绕道也包括锁孔冠脉搭桥手术。必须满足下列全部条件：1.血管造影显示至少两支冠状动脉狭窄超过50或一支冠状动脉狭窄超过70；2.手术须由本公司认可医院的心脏专科医生进行，并确认该手术的必要性。本公司对该种轻症疾病理赔后，不再对6.6.2不典型心肌梗塞、6.6.4微创冠状动脉介入手术承担给付轻症疾病保险金的责任。
6.6.4微创冠状动脉介入手术	微创冠状指被保险人为了治疗明显的冠状动脉狭窄性疾病，首次实际实施了冠状动脉球囊动脉介入扩张成形术、冠状动脉支架植入术、冠状动脉粥样斑块切除术或激光冠状动脉成形术。手术本公司对该种轻症疾病理赔后，不再对6.6.2不典型心肌梗塞、6.6.3微创冠状动脉搭桥手术承担给付轻症疾病保险金的责任。
6.6.5心脏瓣膜介入手术（非开胸手术）	心脏瓣膜为了治疗心脏瓣膜疾病，实际实施了非开胸的经胸壁打孔内镜手术或经皮经导管介入手术介入手术进行的心脏瓣膜置换或修复手术。（非开胸手术）
6.6.6主动脉内手术（非开胸手术）	主动脉内为了治疗主动脉疾病实际实施了经皮经导管进行的动脉内手术。主动脉指胸主动手术（非脉和腹主动脉，不包括胸主动脉和腹主动脉的分支血管。开胸手术）
6.6.7脑垂体瘤、脑囊肿	脑垂体指经头颅断层扫描（CT）、核磁共振（MRI）或其他影像学检查被确诊为下列病变，并实际接受了手术或放射治疗。瘤、脑囊肿1.脑垂体瘤；2.脑囊肿。
6.6.8脑动脉瘤及脑血管	脑动脉瘤指经头颅断层扫描（CT）、核磁共振（MRI）或其他影像学检查被确诊为脑动脉瘤、及脑血管脑血管瘤，并实际接受了手术或放射治疗。
瘤微创颅脑	
6.6.9手术	因疾病被保险人确已实施全麻下的颅骨钻孔手术或者经鼻蝶窦入颅手术。手术因外伤而实施的脑外科手术不在保障范围内。
6.6.10单眼失明	单眼失明指因疾病或意外伤害导致单眼视力永久不可逆（详见释义）性丧失，须满足下列至少一项条件：1.眼球缺失或摘除；2.矫正视力低于0.02（采用国际标准视力表，如果使用其它视力表应进行换算）；3.视野半径小于5度。除眼球缺失或摘除情形外，申请理赔时，被保险人年龄必须在3周岁以上，并且须提供理赔当时的视力丧失诊断及检查证据。
6.6.11视力严重受损	视力严重指因疾病或意外伤害导致双目视力永久不可逆性丧失，虽然未达到本合同所指受损的重大疾病6.9.14双目失明的给付标准，但满足下列全部条件：1.双眼中较好眼矫正视力低于0.1（采用国际标准视力表，如果使用其他视力表应进行换算）；2.双眼中较好眼视野半径小于20度。申请理赔时，被保险人年龄必须在3周岁以上，并且须提供理赔当时的视力丧失诊断及检查证据。
6.6.12角膜移植	角膜移植指为增进视力或治疗某些角膜疾患，已经实施了异体的角膜移植手术。此手术必须在本公司认可医院内由专科医生认为是医疗必需的情况下进行。
6.6.13单耳失聪	单耳失聪指因疾病或者意外伤害导致单耳听力永久不可逆性丧失，在500赫兹、1000赫兹和2000赫兹语音频率下，平均听阈大于90分贝，且经纯音听力测试、声导抗检测或者听觉诱发电位检测等证实。申请理赔时，被保险人年龄必须在3周岁以上，并且须提供理赔当时的听力丧失诊断及检查证据。
6.6.14较小面积度烧伤	较小面积指烧伤程度为度，且度烧伤面积达到全身体表面积的10（百分之十）但少度烧伤于20（百分之二十）。体表面积根据中国新九分法计算。若被保险人已符合本合同所指的重大疾病6.9.20严重度烧伤给付标准的，则不在保障范围内。
6.6.15一肢缺失	一肢缺失指因疾病或意外伤害导致一个肢体自腕关节或踝关节近端（靠近躯干端）以上完全断离。
6.6.16肝叶切除术	肝叶切除指为治疗肝脏肿瘤、肝内胆管结石、肝脓肿、肝包虫病等疾病或因意外而实际实术施的肝脏部分切除术,手术须有至少切除一整叶左肝叶或一整叶右肝叶。此手术必须在本公司认可医院内由专科医生认为是医疗必需的情况下进行。因酒精或者滥用药物引致的疾病或者紊乱及/或者因捐赠肝脏而所需的肝脏手术均不在保障范围内。
6.6.17单侧肾脏切除	单侧肾脏指因疾病或意外事故实际实施的一侧肾脏切除术。切除肾脏部分切除手术和肾脏捐献引起的手术不在保障范围内。
6.6.18双侧睾丸切除术	双侧睾丸指为治疗疾病实际接受了双侧睾丸完全切除手术。部分睾丸切除不在保障范围。切除术
6.6.19双侧卵巢切除术	双侧卵巢指为治疗疾病实际接受了经腹部切开或腹腔镜进行的双侧卵巢完全切除手术。切除术部分卵巢切除不在保障范围。
6.6.20于颈动脉进行血管成形术或内膜切除术	于颈动脉指根据颈动脉造影检查结果，确诊一条或以上颈动脉存在严重狭窄性病变（至少进行血管一支血管管腔直径减少50以上）。本病须经本公司认可医院的专科医生明确诊断，成形术或同时必须已经采取以下手术以减轻症状：1.确实进行动脉内膜切除术；内膜切除术2.确实进行血管介入治疗，例如血管成形术及/或进行植入支架或动脉粥样瘤清除手术。
6.6.21心包膜切除术	心包膜切因心包膜疾病导致已接受心包膜切除术或已进行任何需要心脏小切口技术的手除术术。此手术必须在本公司认可医院内由心脏科医生认为是医疗上必需的情况下进行。
6.6.22硬脑膜下血肿手术	硬脑膜下为清除或引流因意外导致的血肿，需于头部进行开颅或钻孔手术。血肿手术开颅或钻孔手术必须在本公司认可医院内由专科医生认为是医疗必需的情况下进行。
6.6.23特定周围动脉疾病的血管介入治疗	特定周围指为治疗一条或者一条以上的下列动脉狭窄而实施的血管介入治疗：动脉疾病1.为下肢或者上肢供血的动脉；的血管介2.肾动脉；入治疗3.肠系膜动脉。须满足下列全部条件：1.经血管造影术证实一条或者一条以上的上述动脉狭窄达到50或者以上；2.对一条或者一条以上的上述动脉施行了血管介入治疗，如血管成形术及/或者进行植入支架或者动脉粥样瘤清除手术。诊断及治疗均须在本公司认可医院内由血管疾病的专科医生认为是医疗必需的情况下进行。
6.6.24植入腔静脉过滤器	植入腔静指患者因反复肺栓塞发作，抗凝血疗法无效而接受手术植入腔静脉过滤器。脉过滤器此手术须在本公司认可医院内由专科医生认为是医疗必需的情况下进行。
6.6.25糖尿病视网膜晚期增生性病变	糖尿病视因糖尿病而并发视网膜晚期增生性血管病变，并必须符合下列所有理赔条件：网膜晚期1.确诊糖尿病视网膜病变时被保险人已患有糖尿病；2.双眼最佳矫正视力低于0.3（采用国际标准视力表，如果使用其他视力表应进增生性病变行换算）；3.被保险人已确实进行了激光治疗等以改善视力障碍；4.糖尿病视网膜病变的诊断、视力障碍的程度及治疗的医疗之必要性必须由本公司认可医院的眼科专科医生确定。
6.6.26糖尿病导致脚趾截除	糖尿病导因糖尿病引起的神经及血管病变累及足部，为了维持生命在本公司认可医院内已经进行了至少一个脚趾的截除术。致脚趾截除
6.6.27早期象皮病	早期象皮指因丝虫感染导致淋巴管阻塞而造成身体组织出现严重淋巴水肿。此病症须经本病公司认可医院的专科医生根据临床表现和微丝蚴的化验结果确诊。急性淋巴管炎或其它原因引起的淋巴水肿并不在保障范围取
6.6.28心脏起搏器或除颤器植入	心脏起搏因严重心律失常而确实已行植入永久性心脏起搏器或除颤器的手术。理赔时须提器或除颤供完整病历资料及手术记录以证实此严重心律失常并不能以其他方法治疗。器植入诊断及治疗均须在本公司认可医院内由专科医生认为是医疗必需的情况下进
6.6.29严重阻塞性睡眠窒息症	严重阻塞性睡眠窒眠呼吸暂停综合征(OSA)，并必须符合以下两项条件：息症1.被保险人必须现正接受持续气道正压呼吸器(CPAP)之夜间治疗；2.必须提供睡眠测试的文件证明，显示AHI30及夜间血氧饱和平均值85。
6.6.30植入大脑内分流器	植入大脑为缓解已升高的脑脊液压力而确实已在脑室进行分流器植入手术。内分流器诊断及治疗均须在本公司认可医院内由脑神经科专科医生认为是医疗必需的情况下进行。
6.6.31面部重建手术	面部重建确实进行整形或者重建手术（颈部以上的面部构造不完整、缺失或者受损而对其手术形态及外观进行修复或者重建），同时必须由专科医生认为该面部毁容是需要接受住院治疗，及其后接受该手术，而对该面部毁容所进行的治疗亦是医疗所需。因纯粹整容原因、独立的牙齿修复、独立的鼻骨骨折或者独立的皮肤伤口所进行的手术均不在保障范围内。此手术必须在本公司认可医院内由专科医生认为是医疗上必需的情况下进行，并出具诊断证明。
6.6.32因意外毁容而施行的面部整形手术	因意外毁指为修复意外伤害或暴力袭击造成的面部毁损，实际接受了在全身麻醉的情况容而施行下，由整形外科医生实施的对严重损害或变形的面部形态和结构进行修复或重建的面的面部整部整形手术，但未达到本合同所指的重大疾病6.9.82严重面部烧伤的给付标准。形手术面部整形手术必须在意外伤害后的180天内实施。因面部外伤后遗留的线条状瘢痕及色素沉着而施行的手术不在保障范围内。意外伤害必须满足下列全部条件：1.由外在暴力引起并且造成表面可视性伤口和面部骨结构损害的，或面部皮肤三度或全层意外烧伤；2.是造成面部毁损的直接和独立的原因。
6.6.33系统性红斑狼疮	系统性红是一种累及多脏器的自身免疫性的炎症性结缔组织病。其诊断须满足下列两个条斑狼疮件：1.临床表现至少具备如下条件的四个：（1）蝶形红斑或盘形红斑；（2）光敏感；（3）口腔溃疡；（4）非畸形关节炎或多关节痛；（5）浆膜炎、胸膜炎或心包炎；（6）神经系统损伤（癫痫或精神症状）；（7）血象异常（WBC410L或血小板10010L或溶血性贫血）。2.检测结果至少具备如下条件的两个：（1）狼疮细胞或抗双链DNA抗体阳性；（2）抗Sm抗体阳性；（3）抗核抗体阳性；（4）狼疮带试验阳性；（5）C3补体低于正常。
6.6.34严重的骨质疏松	严重的骨由本公司认可医院的专科医生确诊为骨质疏松症合并骨折，并同时符合下列所有质疏松情况：1.因骨质疏松症导致或于骨质疏松症出现时，出现最少1处股骨颈骨折或2处脊椎骨折（如为压缩性骨折，须满足椎体高度或面积减少40及以上）；2.以双能量X光吸收仪或定量电脑断层扫描量度出最少2处位置的骨骼矿物质密度与严重骨质疏松症的定义一致（即低于2.5的T数值）；3.已经就骨折进行内部固定术或置换术治疗；4.诊断及治疗均须在本公司认可医院内由专科医生认为是医疗必需的情况下进行。被保险人确诊患本项疾病的年龄必须在74周岁或以下，才有资格获得本项保障赔偿。
6.6.35轻度原发性肺动脉高压	轻度原发指由于原发性肺动脉高压进行性发展而导致右心室肥厚，已经造成永久不可逆性肺动脉性的体力活动能力受限，达到美国纽约心脏病学会心功能状态分级级，且静息状态高压下肺动脉平均压超过25mmHg，但未达到本合同所指的重大疾病6.9.21严重原发性肺动脉高压的标准。
6.7意外伤害	意外伤害指以外来的、突发的、非本意的、非疾病的客观事件为直接且主要原因导致的身体伤害。
6.8本合同所指的中症疾病	本合同所本合同所指的中症疾病(共20种)，是指符合下列定义的疾病、疾病状态或手术：指的中症疾病
6.8.1轻微脑中风	实际发生了脑血管的突发病变出现神经系统功能障碍表现，并接受住院治疗，头轻微脑中风颅断层扫描（CT）、核磁共振（MRI）等影像学检查证实存在对应病灶，确诊为脑出血、脑栓塞或脑梗塞，在确诊180天后仍然遗留一肢或一肢以上肢体肌力级或级以下的运动功能障碍。短暂性脑缺血发作(TIA)和腔隙性脑梗塞不在本保障范围内。
6.8.2单侧肺脏切除	单侧肺脏因疾病或意外事故实际实施的一侧肺脏切除术。切除肺脏部分切除手术和肺脏捐献引起的手术不在保障范围内。
6.8.3中度严重瘫痪	中度严重指因疾病或者意外伤害导致一肢或一肢以上肢体机能永久完全丧失。肢体机能永瘫痪久完全丧失，指疾病确诊180天后或意外伤害发生180天后，每肢三大关节中的两大关节仍然完全僵硬，或不能随意识活动。肢体是指包括肩关节的整个上肢或包括髋关节的整个下肢。自我伤害，局部瘫痪，病毒感染后的临时瘫痪，或由于心理疾病造成的机能丧失不在保障范围。
6.8.4中度严重昏迷	中度严重处于昏迷的状态，对外界刺激或内在需要毫无反应。昏迷必须持续至少48个小昏迷时，并需要使用插管和机械性呼吸的方法来维持生命。昏迷的诊断及有关证明必须由本公司认可医院的神经专科医生确定。由酗酒或滥用药物直接引起的昏迷并不包括在内。
6.8.5中度严重克隆病	中度严重克隆病是一种慢性肉芽肿性肠炎，具有特征性的克隆病病理组织学变化。诊断克隆病必须由本公司认可医院的专科医生经内窥镜及肠病理活检结果证实，同时经专科医生以类固醇或免疫抑制剂连续治疗至少180天，方符合理赔条件。
6.8.6重度头部外伤	重度头部指因头部遭受机械性外力，引起脑重要部位损伤，导致神经系统永久性的功能障外伤碍。须由头颅断层扫描（CT）、核磁共振检查（MRI）或正电子发射断层扫描（PET）等影像学检查证实。神经系统永久性的功能障碍，指脑损伤180天后，仍完全丧失自主生活能力，无法独立完成六项基本日常生活活动（详见释义）中的两项。早期运动是一组中枢神经系统运动神经元的进行性变性疾病，包括进行性脊肌萎缩症、进神经元疾行性延髓麻痹症、原发性侧索硬化症、肌萎缩性侧索硬化症。须满足自主生活能力完全丧失，无法独立完成六项基本日常生活活动中的两项。
6.8.8	
6.8.7早期运动神经元疾病慢性肾功能障碍	早期运动是一组中枢神经系统运动神经元的进行性变性疾病，包括进行性脊肌萎缩症、进神经元疾行性延髓麻痹症、原发性侧索硬化症、肌萎缩性侧索硬化症。须满足自主生活能力完全丧失，无法独立完成六项基本日常生活活动中的两项。病慢性肾功慢性肾功能障碍是指慢性肾功能不全的晚期。必须满足下列全部条件：能障碍1.肾小球滤过率（使用MDRD公式或CockcroftGault公式计算的结果），低于30ml/min/1.73平方米，且此状态须持续至少90天；2.慢性肾功能障碍的诊断必须由泌尿科或肾脏科医师确诊。
6.8.9早期肝硬化	肝硬化必须由本公司认可医院的专科医生明确诊断。必须由活检证实有再生的早期肝硬化肝细胞结节和典型的肝组织纤维化，下列条件必须全部满足并至少持续一年：1.持续性黄疸，胆红素水平升高超过50mol/L；2.蛋白质合成异常，白蛋白水平低于27g/L；3.异常凝血功能，凝血酶原时间超过正常上限的2倍或以上，或者国际正常化比率（INR）在2.0以上。
6.8.10轻度脑炎或脑膜炎后遗症	轻度脑炎指因患脑炎或脑膜炎导致的神经系统的永久功能障碍。神经系统永久性的功能障或脑膜炎碍，指疾病确诊180天后，仍存在自主生活能力完全丧失，无法独立完成六项基本日后遗症常生活活动中的两项。
6.8.11中度帕金森氏病	中度帕金是一种中枢神经系统的退行性疾病，临床表现为震颤麻痹、共济失调等。必须满森氏病足下列全部条件：1.药物治疗无法控制病情；2.自主生活能力完全丧失，无法独立完成六项基本日常生活活动中的两项。继发性帕金森综合征不在保障范围内。
6.8.12人工耳蜗植入术	人工耳蜗指由于耳蜗的永久损害而实际实施了人工耳蜗植入手术。诊断须经专科医生确认植入术在医学上是必要的，且在植入手术之前已经符合下列全部条件：1.双耳持续12个月以上重度感音神经性耳聋；2.使用相应的听力辅助设备效果不佳。
6.8.13可逆性再生障碍性贫血	可逆性再指因急性可逆性的骨髓造血功能衰竭而导致贫血、中性粒细胞减少和血小板减生障碍性少，必须由血液科医生诊断，且病历资料显示接受了下列任一治疗：贫血1.骨髓刺激疗法至少一个月；2.免疫抑制剂治疗至少一个月；3.接受了骨髓移植。
6.8.14中度严重溃疡性结肠炎	中度严重溃疡性结肠炎是指伴有致命性电解质紊乱及肠道肿胀及有肠破裂的风险的大肠溃疡性结（结肠及直肠）粘膜炎症。须满足下列所有条件：肠炎1.须经由内窥镜检查证实该疾病侵犯全部结肠及直肠，并经病理学组织切片检查证实为溃疡性结肠炎；2.经专科医生以类固醇或免疫抑制剂连续治疗6个月。诊断及治疗均须在本公司认可的医院内由专科医生认为是医疗必需的情况下进
6.8.15中度肌营养不良症	中度肌营养不良症萎缩。须满足下列全部条件：1.肌肉组织活检结果满足肌营养不良症的肌肉细胞变性、坏死等阳性改变；2.自主生活能力严重丧失，无法独立完成六项基本日常生活活动中的两项。本公司承担本项疾病责任不受本合同责任免除中遗传性疾病，先天性畸形、变形或染色体异常的限制。
6.8.16中度严重脊髓灰质炎	中度严重脊髓灰质炎是由于脊髓灰质炎病毒感染所致的瘫痪性疾病，临床表现为运动功能损害或呼吸无力。脊髓灰质炎必须由本公司认可医院的专科医生明确诊断。本合同脊髓灰质炎仅对脊髓灰质炎造成的神经系统功能损害导致被保险人一肢或一肢以上肢体机能永久完全丧失的情况予以理赔。肢体机能永久完全丧失，指疾病确诊180天后，每肢三大关节中的至少一个大关节仍然完全僵硬，或不能随意识活动。
6.8.17因肾上腺皮质腺瘤切除肾上腺	因肾上腺因肾上腺皮质腺瘤所导致的醛固酮分泌过多而产生的继发性恶性高血压而实际皮质腺瘤接受了肾上腺切除术治疗。诊断及治疗均须在本公司认可医院内由专科医生认为是医疗必需的情况下进切除肾上腺行。
6.8.18早期原发性心肌病	早期原发被诊断为原发性心肌病，并符合下列所有条件：性心肌病1.导致心室功能受损，其受损程度达到美国纽约心脏病学会心功能状态分级级，或其同等级e，即：体力活动明显受限，休息时无症状，轻于日常的活动即可引起充血性心力衰竭的症状；2.左室射血分数LVEF35；3.原发性心肌病的诊断必须由本公司认可医院的心脏专科医生确认，并提供心脏超声检查结果报告。本保障范围内的心肌病包括扩张型心肌病、肥厚型心肌病及限制型心肌病。
6.8.19出血性登革热	出血性登出血性登革热须出现全部四种症状，包括发高烧、出血现象、肝肿大和循环衰竭革热（登革热休克综合症即符合WHO登革热第级及第级）。出血性登革热的诊断必须由本公司认可医院的专科医生证实。非出血性登革热不在保障范围内。
6.8.20结核性脊髓炎	结核性脊因结核杆菌引起的脊髓炎，导致永久性神经系统功能中度障碍，即疾病首次确诊髓炎180天后，仍遗留下列一种或一种以上障碍：1.一肢或一肢以上肢体肌力级或级以下的运动功能障碍。2.自主生活能力部分丧失，无法独立完成六项基本日常生活活动中的两项或两项以上。该诊断必须由本公司认可医院的神经专科医生证实。并必须由适当的检查证明为结核性脊髓炎。
6.9本合同所指的重大疾病	本合同所本合同所指的重大疾病（共106种），是指符合下列定义的疾病、疾病状态或手指的重大术：疾病
6.9.1恶性肿瘤	恶性肿瘤指恶性细胞不受控制的进行性增长和扩散，浸润和破坏周围正常组织，可以经血管、淋巴管和体腔扩散转移到身体其他部位的疾病。经病理学检查结果明确诊断，临床诊断属于世界卫生组织疾病和有关健康问题的国际统计分类（ICD10）的恶性肿瘤范畴。下列疾病不在保障范围内：1.原位癌；2.相当于Binet分期方案A期程度的慢性淋巴细胞白血病；3.相当于AnnArbor分期方案期程度的何杰金氏病；4.皮肤癌（不包括恶性黑色素瘤及已发生转移的皮肤癌）；5.TNM分期为TNM期或更轻分期的前列腺癌；6.感染艾滋病病毒或患艾滋病期间所患恶性肿瘤。
6.9.2急性心肌梗塞	急性心肌指因冠状动脉阻塞导致的相应区域供血不足造成部分心肌坏死。须满足下列至少梗塞三项条件：1.典型临床表现，例如急性胸痛等；2.新近的心电图改变提示急性心肌梗塞；3.心肌酶或肌钙蛋白有诊断意义的升高，或呈符合急性心肌梗塞的动态性变化；4.发病90天后，经检查证实左心室功能降低，如左心室射血分数低于50。
6.9.3脑中风后遗症	脑中风后指因脑血管的突发病变引起脑血管出血、栓塞或梗塞，并导致神经系统永久性的遗症功能障碍。神经系统永久性的功能障碍，指疾病确诊180天后，仍遗留下列一种或一种以上障碍：1.一肢或一肢以上肢体机能完全丧失；2.语言能力或咀嚼吞咽能力完全丧失；3.自主生活能力完全丧失，无法独立完成六项基本日常生活活动中的三项或三项以上。肢体机能完全丧失：指肢体的三大关节中的两大关节僵硬，或不能随意识活动。肢体是指包括肩关节的整个上肢或包括髋关节的整个下肢。语言能力或咀嚼吞咽能力完全丧失：语言能力完全丧失，指无法发出四种语音（包括口唇音、齿舌音、口盖音和喉头音）中的任何三种、或声带全部切除，或因大脑语言中枢受伤害而患失语症；咀嚼吞咽能力完全丧失，指因牙齿以外的原因导致器质障碍或机能障碍，以致不能作咀嚼吞咽运动，除流质食物外不能摄取或吞咽的状态。
6.9.4重大器官移植术或造血干细胞移植术	重大器官重大器官移植术，指因相应器官功能衰竭，已经实施了肾脏、肝脏、心脏或肺脏移植术或的异体移植手术。造血干细造血干细胞移植术，指因造血功能损害或造血系统恶性肿瘤，已经实施了造血干胞移植术细胞（包括骨髓造血干细胞、外周血造血干细胞和脐血造血干细胞）的异体移植手术。
6.9.5冠状动脉搭桥术（或称冠状动脉旁路移植术）	冠状动脉指为治疗严重的冠心病，实际实施了开胸进行的冠状动脉血管旁路移植的手术。搭桥术冠状动脉支架植入术、心导管球囊扩张术、激光射频技术及其他非开胸的介入（或称冠手术、腔镜手术不在保障范围内。状动脉旁路移植术）
6.9.6终末期肾病（或称慢性肾功能衰竭尿毒症期）	终末期肾指双肾功能慢性不可逆性衰竭，达到尿毒症期，经诊断后已经进行了至少90天病（或称的规律性透析治疗或实施了肾脏移植手术。慢性肾功能衰竭尿毒症期）
6.9.7多个肢体缺失	多个肢体指因疾病或意外伤害导致两个或两个以上肢体自腕关节或踝关节近端（靠近躯干缺失端）以上完全性断离。
6.9.8急性或亚急性重症肝炎	急性或亚指因肝炎病毒感染引起肝脏组织弥漫性坏死，导致急性肝功能衰竭，且经血清学急性重症或病毒学检查证实，并须满足下列全部条件：肝炎1.重度黄疸或黄疸迅速加重；2.肝性脑病；3.B超或其他影像学检查显示肝脏体积急速萎缩；4.肝功能指标进行性恶化。
6.9.9良性脑肿瘤	指脑的良性肿瘤，已经引起颅内压增高，临床表现为视神经乳头水肿、精神症状、良性脑肿瘤癫痫及运动感觉障碍等，并危及生命。须由头颅断层扫描（CT）、核磁共振检查（MRI）或正电子发射断层扫描（PET）等影像学检查证实，并须满足下列至少一项条件：1.实际实施了开颅进行的脑肿瘤完全切除或部分切除的手术；2.实际实施了对脑肿瘤进行的放射治疗。脑垂体瘤、脑囊肿、脑血管性疾病不在保障范围内。
6.9.10慢性肝功能衰竭失代偿期	慢性肝功指因慢性肝脏疾病导致肝功能衰竭。须满足下列全部条件：能衰竭失1.持续性黄疸；代偿期2.腹水；3.肝性脑病；4.充血性脾肿大伴脾功能亢进或食管胃底静脉曲张。因酗酒或药物滥用导致的肝功能衰竭不在保障范围内。
6.9.11脑炎后遗症或脑膜炎后遗症	脑炎后遗指因患脑炎或脑膜炎导致的神经系统永久性的功能障碍。神经系统永久性的功能症或脑膜障碍，指疾病确诊180天后，仍遗留下列一种或一种以上障碍：炎后遗症1.一肢或一肢以上肢体机能完全丧失；2.语言能力或咀嚼吞咽能力完全丧失；3.自主生活能力完全丧失，无法独立完成六项基本日常生活活动中的三项或三项以上。
6.9.12深度昏迷	深度昏迷指因疾病或意外伤害导致意识丧失,对外界刺激和体内需求均无反应,昏迷程度按照格拉斯哥昏迷分级（Glasgowcomascale）结果为5分或5分以下，且已经持续使用呼吸机及其他生命维持系统96小时以上。因酗酒或药物滥用导致的深度昏迷不在保障范围内。
6.9.13双耳失聪	双耳失聪指因疾病或意外伤害导致双耳听力永久不可逆性丧失，在500赫兹、1000赫兹和2000赫兹语音频率下，平均听阈大于90分贝，且经纯音听力测试、声导抗检测或听觉诱发电位检测等证实。申请理赔时，被保险人年龄必须在3周岁以上，并且须提供理赔当时的听力丧失诊断及检查证据。
6.9.14双目失明	双目失明指因疾病或意外伤害导致双眼视力永久不可逆性丧失，双眼中较好眼须满足下列至少一项条件：1.眼球缺失或摘除；2.矫正视力低于0.02（采用国际标准视力表，如使用其他视力表应进行换算）；3.视野半径小于5度。除眼球缺失或摘除情形外，申请理赔时，被保险人年龄必须在3周岁以上，并且须提供理赔当时的视力丧失诊断及检查证据。
6.9.15瘫痪	瘫痪指因疾病或意外伤害导致两肢或两肢以上肢体机能永久完全丧失。肢体机能永久完全丧失，指疾病确诊180天后或意外伤害发生180天后，每肢三大关节中的两大关节仍然完全僵硬，或不能随意识活动。
6.9.16心脏瓣膜手术	心脏瓣膜指为治疗心脏瓣膜疾病，实际实施了开胸进行的心脏瓣膜置换或修复的手术。手术
6.9.17严重阿尔茨海默病	严重阿尔指因大脑进行性、不可逆性改变导致智能严重衰退或丧失，临床表现为明显的认茨海默病知能力障碍、行为异常和社交能力减退，其日常生活必须持续受到他人监护。须由头颅断层扫描（CT）、核磁共振检查（MRI）或正电子发射断层扫描（PET）等影像学检查证实，且自主生活能力完全丧失，无法独立完成六项基本日常生活活动中的三项或三项以上。神经官能症和精神疾病不在保障范围内。
6.9.18严重脑损伤	严重脑损指因头部遭受机械性外力，引起脑重要部位损伤，导致神经系统永久性的功能障伤碍。须由头颅断层扫描（CT）、核磁共振检查（MRI）或正电子发射断层扫描（PET）等影像学检查证实。神经系统永久性的功能障碍，指脑损伤180天后，仍遗留下列一种或一种以上障碍：1.一肢或一肢以上肢体机能完全丧失；2.语言能力或咀嚼吞咽能力完全丧失；3.自主生活能力完全丧失，无法独立完成六项基本日常生活活动中的三项或三项以上。
6.9.19严重帕金森病	严重帕金是一种中枢神经系统的退行性疾病，临床表现为震颤麻痹、共济失调等。须满足森病下列全部条件：1.药物治疗无法控制病情；2.自主生活能力完全丧失，无法独立完成六项基本日常生活活动中的三项或三项以上。继发性帕金森综合征不在保障范围内。
6.9.20严重度烧伤	严重度指烧伤程度为度，且度烧伤的面积达到全身体表面积的20或20以上。体烧伤表面积根据中国新九分法计算。
6.9.21严重原发性肺动脉高压	严重原发指不明原因的肺动脉压力持续性增高，进行性发展而导致的慢性疾病，已经造成性肺动脉永久不可逆性的体力活动能力受限，达到美国纽约心脏病学会心功能状态分级级，高压且静息状态下肺动脉平均压超过30mmHg。美国纽约心脏病学会心功能状态分级级是指有医院的医疗记录显示病人不能进行任何活动，休息时仍有心悸、呼吸困难等心力衰竭表现。
6.9.22严重运动神经元病	严重运动是一组中枢神经系统运动神经元的进行性变性疾病，包括进行性脊肌萎缩症、进神经元病行性延髓麻痹症、原发性侧索硬化症、肌萎缩性侧索硬化症。须满足自主生活能力完全丧失，无法独立完成六项基本日常生活活动中的三项或三项以上的条件。
6.9.23语言能力丧失	语言能力指因疾病或意外伤害导致完全丧失语言能力，经过积极治疗至少12个月（声带丧失完全切除不受此时间限制），仍无法通过现有医疗手段恢复。精神心理因素所致的语言能力丧失不在保障范围内。申请理赔时，被保险人年龄必须在3周岁以上，并且须提供理赔当时的语言能力丧失诊断及检查证据。
6.9.24重型再生障碍性贫血	重型再生指因骨髓造血功能慢性持续性衰竭导致的贫血、中性粒细胞减少及血小板减少。须满足下列全部条件：障碍性贫血1.骨髓穿刺检查或骨髓活检结果支持诊断；2.外周血象须具备以下三项条件：（1）中性粒细胞绝对值0.510/L；（2）网织红细胞1；（3）血小板绝对值2010/L。
6.9.25主动脉手术	指为治疗主动脉疾病，实际实施了开胸或开腹进行的切除、置换、修补病损主动主动脉手术脉血管的手术。主动脉指胸主动脉和腹主动脉，不包括胸主动脉和腹主动脉的分支血管。动脉内血管成形术不在保障范围内。
6.9.26胰腺移植	胰腺移植指胰腺功能衰竭，已经实施了在全身麻醉下进行的胰腺的异体器官移植手术。单纯胰岛移植、部分胰腺组织或细胞的移植不在本保障范围内。
6.9.27埃博拉病毒感染	埃博拉病指埃博拉病毒感染导致的烈性传染病，并须满足下列全部条件：毒感染1.实验室检查证实埃博拉病毒的存在；2.从发病开始有超过30天的进行性感染症状。
6.9.28丝虫病所致象皮肿	丝虫病所指末期丝虫病，按国际淋巴学会分级为三度淋巴水肿，其临床表现为肢体非凹陷致象皮肿性水肿伴畸形增大、硬皮症和疣状增生。此病症须经本公司认可的专科医生根据临床表现和微丝蚴的化验结果确诊。
6.9.29主动脉夹层血肿	主动脉夹是指主动脉壁在受到某些病理因素的破坏后，高速、高压的主动脉血流将其内膜层血肿撕裂，以致主动脉腔内的血流通过主动脉内膜的破裂口进入主动脉内壁而形成血肿。被保险人需通过X线断层扫描（CT）、磁共振扫描（MRI）、磁共振血管检验法（MRA）或血管扫描等检查，并且实施了胸腹切开的直视主动脉手术。
6.9.30疯牛病	疯牛病神经系统疾病及致命的成胶质状脑病，并有以下症状：1.不能控制的肌肉痉挛及震颤；2.逐渐痴呆；3.小脑功能不良，共济失调；4.手足徐动症。诊断必须由神经科专科医生基于以下检查报告作出：脑电图、脑脊液报告、电脑断层扫描(CT)及核磁共振(MRI)。
6.9.31破裂脑动脉瘤夹闭手术	破裂脑动指因脑动脉瘤破裂造成蛛网膜下腔出血，被保险人实际接受了在全麻下进行的开脉瘤夹闭颅动脉夹闭手术。手术脑动脉瘤（未破裂）预防性手术、颅骨打孔手术、动脉瘤栓塞手术、血管内手术及其他颅脑手术不在本保障范围内。
6.9.32经输血导致的HIV感染	经输血导是指被保险人感染上人类免疫缺陷病毒（HIV）并且符合下列所有条件：致的HIV1.被保险人因治疗必需而接受输血，并且因输血而感染人类免疫缺陷病毒（HIV）；感染2.提供输血治疗的输血中心或医院出具该项输血感染属医疗责任事故的报告，或者法院终审裁定为医疗责任并且不准上诉；3.提供输血治疗的输血中心或医院必须拥有合法经营执照；4.受感染的被保险人不是血友病患者。在任何治愈艾滋病或阻止人类免疫缺陷病毒（HIV）病毒作用的疗法被发现以后，或能防止艾滋病发生的医疗方法被研究出来以后，本保障将不再予以赔付。本公司必须拥有获得使用被保险人的所有血液样本的权利和能够对这些样本进行独立检验的权利。本公司承担本项疾病责任不受本合同责任免除中被保险人感染艾滋病病毒或患艾滋病的限制。
6.9.33器官移植导致的HIV感染	器官移植指因进行器官移植而感染上人类免疫缺陷病毒（HIV），且须满足下列全部条件：导致的1.被保险人因治疗必需而实施器官移植，并且因器官移植而感染人类免疫缺陷病HIV感染毒（HIV）；2.提供器官移植治疗的器官移植中心或医院出具该项器官移植感染，属于医疗责任事故的报告，或者法院终审裁定为医疗责任并且不准上诉；3.提供器官移植治疗的器官移植中心或医院必须拥有合法经营执照。在任何治愈艾滋病或阻止人类免疫缺陷病毒（HIV）病毒作用的疗法被发现以后，或能防止艾滋病发生的医疗方法被研究出来以后，本保障将不再予以赔付。本公司必须拥有获得使用被保险人的所有血液样本的权利和能够对这些样本进行独立检验的权利。本公司承担本项疾病责任不受本合同责任免除中被保险人感染艾滋病病毒或患艾滋病的限制。
6.9.34因职业关系导致的HIV感染	因职业关被保险人在其常规职业工作过程中遭遇外伤，或职业需要处理血液或其它体液时系导致的感染上人类免疫缺陷病毒（HIV）。必须满足下列全部条件：HIV感染1.感染必须是在被保险人正在从事其职业工作中发生，该职业必须属于下列限定职业范围内的职业；2.血清转化必须出现在事故发生后的6个月以内；3.必须提供被保险人在所报事故后发生的5天以内进行的检查报告，该报告必须显示被保险人血液人类免疫缺陷病毒（HIV）阴性和/或人类免疫缺陷病毒（HIV）抗体阴性；4.必须在事故发生后的12个月内证实被保险人体内存在人类免疫缺陷病毒（HIV）或人类免疫缺陷病毒（HIV）抗体。限定职业：医生和牙科医生、护士、医院化验室工作人员、医院护工、医生助理和牙医助理、救护车工作人员、助产士、消防队员、警察、狱警。在任何治愈艾滋病或阻止人类免疫缺陷病毒（HIV）病毒作用的疗法被发现以后，或能防止艾滋病发生的医疗方法被研究出来以后，本保障将不再予以赔付。本公司必须拥有获得使用被保险人的所有血液样本的权利和能够对这些样本进行独立检验的权利。本公司承担本项疾病责任不受本合同责任免除中被保险人感染艾滋病病毒或患艾滋病的限制。
6.9.35原发性硬化性胆管炎	原发性硬指一种胆汁淤积综合征，其特征是肝内、肝外胆道因纤维化性炎症逐渐狭窄，并最终导致完全阻塞而发展为肝硬化。本病须经内镜逆行胰胆管造影等影像学检查证化性胆管炎实，并须满足下列全部条件：1.总胆红素和直接胆红素同时升高，血清ALP200U/L；2.持续性黄疸病史；3.出现胆汁性肝硬化或门脉高压。因肿瘤或胆管损伤等继发性的硬化性胆管炎不在保障范围内。
6.9.36特发性慢性肾上腺皮质功能减退	特发性慢指自身免疫性肾上腺炎（既往称：特发性肾上腺皮质萎缩）导致肾上腺萎缩和慢性肾上腺性肾上腺皮质功能减退。必须满足所有以下条件：皮质功能1.明确诊断，符合所有以下诊断标准；减退（1）血浆促肾上腺皮质激素(ACTH)水平测定大于100pg/ml；（2）血浆和尿游离皮质醇及尿17羟皮质类固醇、17酮皮质类固醇测定、血浆肾素活性、血管紧张素和醛固酮测定，显示为原发性肾上腺皮质功能减退症；（3）促肾上腺皮质激素(ACTH)刺激试验显示为原发性肾上腺皮质功能减退症。2.已经采用皮质类固醇替代治疗180天以上。本保障仅包括由自身免疫功能紊乱所导致的慢性肾上腺功能减退，其他成因（包括但不限于：肾上腺结核、HIV感染或艾滋病、感染、肿瘤）所致的原发性肾上腺皮质功能减退和继发性肾上腺皮质功能减退均不在保障范围内。
6.9.37系统性红斑狼疮（并发）型或以上狼疮性肾炎	系统性红系统性红斑狼疮是由多种因素引起，累及多系统的自身免疫性疾病。其特点是生斑狼疮成自身抗体对抗多种自身抗原。多见于育龄妇女。（并发）本合同所指的系统性红斑狼疮仅限于累及肾脏（经肾脏活检确认的，符合WHO型或以诊断标准定义型至V型狼疮性肾炎）的系统性红斑狼疮。其他类型的红斑性狼疮，上狼疮性如盘状狼疮、仅累及血液及关节的狼疮不在保障范围取Ｉ鲅妆炯膊”匦胗杀竟司认可医院的免疫和风湿科专科医生确诊。世界卫生组织（WHO）狼疮性肾炎分型：
6.9.38严重类风湿性关节炎	严重类风类风湿性关节炎为广泛分布的慢性进行性多关节病变，表现为关节严重变形，侵犯至少三个主要关节或关节组（如：双手（多手指）关节、双足（多足趾）关节、双湿性关节炎腕关节、双膝关节和双髋关节）。类风湿性关节炎必须明确诊断并且已经达到类风湿性关节炎功能分级级以上的功能障碍（关节活动严重限制，不能完成大部分的日常工作和活动）并且满足下列全部条件：1.晨僵；2.对称性关节炎；3.类风湿性皮下结节；4.类风湿因子滴度升高。
6.9.39重症急性坏死性筋膜炎	重症急性坏死性筋膜炎的诊断须同时符合下列要求：坏死性筋1.符合坏死性筋膜炎的一般临床表现；膜炎2.细菌培养检出致病菌；3.出现广泛性肌肉及软组织坏死，并导致身体受影响部位永久完全失去功能。所谓永久完全失去功能是指受影响部位的全部功能完全丧失超过180天者。
6.9.40急性坏死性胰腺炎开腹手术	急性坏死指被保险人因为急性出血坏死性胰腺炎已经接受了外科开腹手术治疗，以进行坏性胰腺炎死组织清除、坏死病灶切除或胰腺切除。开腹手术因饮酒所致的急性出血坏死性胰腺炎或经腹腔镜手术进行的治疗不在保障范围
6.9.41系统性硬皮病	系统性硬皮病纤维化。诊断必须经活检及血清学检查证实，疾病必须是全身性，且须满足下列至少一项条件：1.肺脏：肺部病变进而发展为肺间质纤维化和肺动脉高压；2.心脏：心功能受损达到美国纽约心脏病学会心功能状态分级级；3.肾脏：肾脏受损导致双肾功能慢性不可逆衰竭，达到尿毒症期。以下情况不在保障范围内：1.局限性硬皮病（带状硬皮病或斑状损害）2.嗜酸性筋膜炎3.CREST综合征
6.9.42慢性复发性胰腺炎	慢性复发胰腺炎反复发作超过三次以上并导致胰腺功能紊乱和营养不良，需要接受酶替代性胰腺炎治疗。诊断必须有消化科专科医生确认并且有内窥镜逆行胰胆管造影所证实。因酒精所致的慢性复发性胰腺炎除外。
6.9.43严重肌营养不良症	严重肌营指一组原发于肌肉的遗传性疾病，临床表现为与神经系统无关的肌肉无力和肌肉养不良症萎缩。须满足下列全部条件：1.肌肉组织活检结果满足肌营养不良症的肌肉细胞变性、坏死等阳性改变；2.自主生活能力严重丧失，无法独立完成六项基本日常生活活动中的三项或三项以上。本公司承担本项疾病责任不受本合同责任免除中遗传性疾病，先天性畸形、变形或染色体异常的限制。
6.9.44严重克隆病	严重克隆克隆病是一种慢性肉芽肿性肠炎，具有特征性的克隆病病理组织学变化。诊断必病须由病理检查结果证实。被保险人所患的克隆病必须已经造成瘘管形成并伴有肠梗阻或肠穿孔。
6.9.45严重溃疡性结肠炎	严重溃疡溃疡性结肠炎是指伴有致命性电解质紊乱的急性暴发性溃疡性结肠炎，病变累及性结肠炎全结肠，表现为严重的血便和系统性症状体征，治疗通常采取全结肠切除和回肠造瘘术。溃疡性结肠炎必须根据组织病理学特点诊断，并且被保险人已经接受了结肠切除和回肠造瘘术。
6.9.46溶血性链	溶血性链包围肢体或躯干的浅筋膜和/或深筋膜受到溶血性链球菌的感染，病情在短时间
球菌引起的坏疽	内急剧恶化，已经立刻进行了手术及清创术。最后的诊断必须由微生物或病理学专家的坏疽进行相关检查后证实。
6.9.47脊髓灰质炎	脊髓灰质是由于脊髓灰质炎病毒感染所致的瘫痪性疾病，临床表现为运动功能损害或呼吸炎无力。脊髓灰质炎必须由本公司认可医院的专科医生明确诊断。本合同仅对脊髓灰质炎造成的神经系统功能损害导致被保险人一肢或一肢以上肢体机能永久完全丧失的情况予以理赔。肢体机能永久完全丧失，指疾病确诊180天后或意外伤害发生180天后，每肢三大关节中的两大关节仍然完全僵硬，或不能随意识活动。
6.9.48植物人状态	植物人状指脑皮质广泛性坏死而导致对自身及周边的认知能力完全丧失,但脑干功能依然态存在。必须由神经专科医生明确诊断,并有头颅断层扫描（CT），核磁共振检查（MRI）或正电子发射断层扫描（PET）等影像学检查证实。上述情况必须有至少一个月的病历记录加以证实。由于酗酒或滥用药物所致的植物人状态不在保障范围内。
6.9.49严重1型糖尿病	严重1型严重1型糖尿病为由于胰岛素分泌绝对不足引起的慢性血糖升高，且已经持续性糖尿病地依赖外源性胰岛素维持180日以上。须经血胰岛素测定、血C肽测定或尿C肽测定，结果异常，并由内分泌科专科医生明确诊断。并须在本合同有效期内，满足下述至少两个条件：1.已出现增殖性视网膜病变；2.须植入心脏起搏器治疗心脏病；3.在本公司认可医院内已经进行了医疗必需的由足踝或以上位置的单足截除手
6.9.50非阿尔茨海默病所致严重痴呆	非阿尔茨海默病所严重痴呆，临床表现为明显的认知能力障碍、行为异常和社交能力减退。被保险人自主生活能力完全丧失，无法独立完成六项基本日常生活活动中的三项或三项以上，日致严重痴呆常生活必须持续受到他人监护。导致痴呆的疾病必须明确诊断，并且由完整的临床、实验室和影像学检查结果证实。神经官能症和精神疾病不在保障范围内。
6.9.51严重冠状动脉粥样硬化性心脏病	严重冠状指经冠状动脉造影检查明确诊断为主要血管严重狭窄性病变，须满足下列至少一动脉粥样项条件：硬化性心1.左冠状动脉主干和右冠状动脉中，一支血管管腔堵塞75以上，另一支血管管脏病腔堵塞60以上；2.左前降支、左旋支和右冠状动脉中，至少一支血管管腔堵塞75以上，其他两支血管管腔堵塞60以上。左前降支的分支血管、左旋支的分支血管及右冠状动脉的分支血管的狭窄不作为本保障的衡量指标。
6.9.52多发性硬化	多发性硬被保险人因脑及脊髓内的脱髓鞘病变而出现神经系统多灶性（多发性）多时相（至化少6个月以内有一次以上（不包含一次）的发作）的病变，须由计算机断层扫描（CT）、核磁共振检查（MRI）或正电子发射断层扫描（PET）等影像学检查证实，且已经造成自主生活能力完全丧失，无法独立完成六项基本日常生活活动中的三项或三项以上，持续至少180天。
6.9.53全身性（型）重症肌无力	全身性是指一种神经与肌肉接头部位传递障碍的自身免疫性疾病，临床特征是局部或全（型）重身横纹肌于活动时易于疲劳无力，颅神经眼外肌最易累及，也可涉及呼吸肌、下肢近症肌无力端肌群以至全身肌肉，须经本公司认可的神经科医师确诊。其诊断必须同时具有下列情况：1.经药物、胸腺手术治疗一年以上无法控制病情，丧失正常工作能力；2.出现眼睑下垂，或延髓肌受累引起的构音困难、进食呛咳,或由于肌无力累及延髓肌、呼吸肌而致机体呼吸功能不正常的危急状态即肌无力危象；3.症状缓解、复发及恶化交替出现，临床接受新斯的明等抗胆碱酯酶药物治疗的病史。
6.9.54严重心肌病	严重心肌指不明原因引起的一类心肌病变，包括原发性扩张型心肌病、原发性肥厚型心肌病病及原发性限制型心肌病三种，病变必须已造成事实上心室功能障碍而出现明显的心功能衰竭（达到美国纽约心脏病学会心功能状态分级级），且有相关住院医疗记录显示级心功能衰竭状态持续至少180天。本疾病必须由本公司认可医院的专科医生明确诊断。继发于全身性疾病或其它器官系统疾病造成的心肌病变除外。
6.9.55慢性呼吸功能衰竭终末期肺病	慢性呼吸慢性肺部疾病导致永久不可逆性的慢性呼吸功能衰竭。慢性呼吸功能衰竭必须功能衰竭明确诊断并满足下列全部条件：1.动脉血氧分压（PaO2）50mmHg；终末期肺病2.动脉血氧饱和度（SaO2）80；3.因缺氧必须接受持续的输氧治疗。理赔时必须提供以上三项相应的证明文件或检查报告。
6.9.56严重心肌炎	严重心肌指心肌局限性或弥漫性的急性或慢性炎症病变，导致心脏功能障碍，达到美国炎纽约心脏病学会心功能状态分级级，且需持续至少90天。
6.9.57肺淋巴管肌瘤病	肺淋巴管肺淋巴管肌瘤病是一种弥漫性肺部疾病，主要病理改变为肺间质、支气管、血管肌瘤病和淋巴管内出现未成熟的平滑肌异常增生，同时需满足下列全部条件：1.经组织病理学诊断；2.CT显示双肺弥漫性囊性改变；3.休息时出现呼吸困难并经本公司认可医院的专科医生认可有必要进行肺移植手术。
6.9.58侵蚀性葡萄胎（或称恶性葡萄胎）	侵蚀性葡该类疾病是指异常增生的绒毛组织浸润性生长浸入子宫肌层或转移至其他器官萄胎（或或组织的葡萄胎，并已经进行化疗或手术治疗的。称恶性葡萄胎）
6.9.59度房室传导阻滞	度房室指心房激动在房室交界区、房室束及其分支内发生阻滞，不能正常地传到心室的传导阻滞心脏传导性疾病，须满足下列所有条件：1.心电图显示房室搏动彼此独立，心室率50次/分钟；2.出现阿斯综合征或心力衰竭的表现；3.必须持续性依赖心脏起搏器维持心脏正常功能，且已经放置心脏起搏器。
6.9.60感染性心内膜炎	感染性心指因细菌、真菌和其他微生物（如病毒、立克次体、衣原体、螺旋体等）直接感内膜炎染而产生心瓣膜或心室壁内膜的炎症，须经心脏专科医生确诊，并符合以下所有条件：1.血液培养测试结果为阳性，并至少符合以下条件之一：（1）微生物：在赘生物，栓塞的赘生物或心脏内脓肿培养或组织检查证实有微生物；（2）病理性病灶：组织检查证实赘生物或心脏内脓肿有活动性心内膜炎；（3）分别两次血液培养证实有典型的微生物且与心内膜炎符合；（4）持续血液培养证实有微生物阳性反应，且与心内膜炎符合。2.心内膜炎引起中度心瓣膜关闭不全（指返流指数20或以上）或中度心瓣膜狭窄（指心瓣膜开口范围小于或等于正常的30）；3.心内膜炎及心瓣膜损毁程度需经由心脏专科医生确诊。
6.9.61肝豆状核变性	肝豆状核肝豆状核变性是一种可能危及生命的铜代谢疾病，以铜沉积造成的渐进性肝功能变性损害及/或神经功能恶化为特征。必须由本公司认可医院的专科医生通过肝脏活组织检查结果确定诊断并配合螯合剂治疗持续至少6个月。本公司承担本项疾病责任不受本合同责任免除中遗传性疾病，先天性畸形、变形或染色体异常的限制。
6.9.62肺源性心脏病	肺源性心指由于各种胸肺及支气管病变而继发的肺动脉高压，最后导致以右室肥大为特征脏病的心脏病。须经呼吸专科医生确诊，且必须同时满足如下诊断标准：1.左心房压力增高（不低于20个单位）；2.肺血管阻力高于正常值3个单位（PulmonaryResistance）；3.肺动脉血压不低于40mmHg；4.肺动脉楔压不低于6mmHg；5.右心室心脏舒张期末压力不低于8mmHg；6.右心室过度肥大、扩张，出现右心衰竭和呼吸困难。
6.9.63肾髓质囊性病	肾髓质囊肾髓质囊性病的诊断须同时符合下列要求：性病1.肾髓质有囊肿、肾小管萎缩及间质纤维化等病理改变；2.肾功能衰竭；3.诊断须由肾组织活检确定。本公司承担本项疾病责任不受本合同责任免除中遗传性疾病，先天性畸形、变形或染色体异常的限制。
6.9.64严重继发性肺动脉高压	严重继发继发性肺动脉压力持续增高，导致右心室肥厚，已经造成永久不可逆性的体力性肺动脉活动能力受限，达到美国纽约心脏病学会心功能状态分级级。诊断需要由心脏科专高压家确诊，并且心导管检查报告显示静息状态下肺动脉平均压超过30mmHg。所有先天性心脏疾病直接或间接引起的肺动脉高压不在保障范围内。
6.9.65进行性核	进行性核一种隐袭起病、逐渐加重的神经系统变性疾病。本疾病必须由本公司认可医院的上性麻痹神经科专科医生确诊，并须满足下列所有条件：1.步态共济失调；2.对称性眼球垂直运动障碍；3.假性球麻痹，表现为构音障碍和吞咽困难。
6.9.66失去一肢及一眼	失去一肢因疾病或意外伤害导致单眼视力丧失及任何一肢自腕关节或踝关节近端（靠近躯及一眼干端）以上完全性断离。单眼视力丧失指单眼视力永久不可逆性丧失，患眼须满足下列至少一项条件：1.眼球缺失或摘除；2.矫正视力低于0.02（采用国际标准视力表，如果使用其它视力表应进行换算）；3.视野半径小于5度。除眼球缺失或摘除情形外，申请理赔时，被保险人年龄必须在3周岁以上，并且须提供理赔当时的视力丧失诊断及检查证据。
6.9.67嗜铬细胞瘤	嗜铬细胞是指肾上腺或嗜铬外组织出现神经内分泌肿瘤，并分过多的儿茶酚胺类，需要瘤确实进行手术以切除肿瘤。嗜铬细胞瘤的诊断必须由内分泌专科医生确定。
6.9.68小肠移植	小肠移植指因肠道疾病或外伤，已经实施了在全身麻醉下进行的小肠的异体器官移植手术。此手术必须由专科医生认为是医学上必需的情况下进行。
6.9.69颅脑手术	颅脑手术被保险人确已实施全麻下的开颅手术（不包括颅骨钻孔手术和经鼻蝶窦入颅手术）。因外伤而实施的脑外科手术不在保障范围之内。理赔时必须提供由神经外科医生出具的诊断书及手术报告。
6.9.70严重自身免疫性肝炎	严重自身自身免疫性肝炎是一种原因不明的慢性肝脏的坏死性炎性疾病，机体免疫机制被破坏，产生针对肝脏自身抗原的抗体导致自身免疫反应，从而破坏肝细胞造成肝脏炎免疫性肝炎症坏死，进而发展为肝硬化。必须满足所有以下条件：1.高球蛋白血症；2.血液中存在高水平的自身免疫抗体，如ANA（抗核抗体）、SMA（抗平滑肌抗体）、抗LKM1抗体或抗SLA/LP抗体；3.肝脏活检证实免疫性肝炎；4.临床已经出现腹水、食道静脉曲张和脾肿大等肝硬化表现。
6.9.71原发性骨髓纤维化	原发性骨原发性骨髓纤维化为原因不明的骨髓中成纤维细胞增殖，伴有髓外造血，表现为髓纤维化进行性贫血、脾肿大等症状。本疾病须根据骨髓的活组织检查和周围血象检查由本公司认可医院的血液科专科医生明确诊断，并至少符合下列条件中的三项，且符合条件的状态持续180天及以上，并已经实际实施了针对此症的治疗：1.血红蛋白100g/L；2.白细胞计数2510/L；3.外周血原始细胞1；4.血小板计数10010/L。任何其它病因导致的继发性骨髓纤维化不在保障范围内。
6.9.72严重获得性或继发性肺泡蛋白质沉积症	严重获得因获得性或继发性原因导致双肺肺泡和细支气管腔内充满不可溶性富磷脂蛋白性或继发的疾病。理赔时须满足下列所有条件：性肺泡蛋1.支气管镜活检或开胸肺活检病理检查证实肺泡内充满有过碘酸雪夫（PAS）染色阳性的蛋白样物质；白质沉积症2.被保险人因中重度呼吸困难或低氧血症而实际已行全身麻醉下的全肺灌洗治
6.9.73严重慢性缩窄性心包炎	严重慢性缩窄性心形成一个纤维瘢痕外壳，使心脏和大血管根部受压，阻碍心脏的舒张。包炎被保险人被明确诊断为慢性缩窄性心包炎且必须满足以下所有条件：1.心功能衰竭达到美国纽约心脏病学会心功能状态分级级，并持续180天以上；2.实际接收了以下任何一种手术路径的心包剥脱或心包切除手术；手术路径：胸骨正中切口；双侧前胸切口；左前胸肋间切口。经胸腔镜、胸壁打孔进行的手术、心包粘连松解手术不在保障范围内。
6.9.74独立能力丧失	独立能力是指由本公司认可的医院的专科医生确认被保险人已持续180天无法独立完成丧失六项基本日常生活活动中的三项或三项以上。被保险人首次被确诊罹患本项疾病时的年龄必须在18周岁至74周岁之间，才有资格获得本项保障赔偿。所有与精神病有关的疾病原因均不属于本项保障范围内。
6.9.75胆道重建手术	胆道重建指因疾病或胆道创伤导致接受涉及胆总管小肠吻合术的胆道重建手术。手术必手术须在本公司认可医院内由专科医生认为是医疗必需的情况下进行。胆道闭锁不在保障范围内。
6.9.76主动脉夹层瘤	主动脉夹指主动脉的内膜破裂导致血液流入主动脉壁中形成夹层动脉瘤。在本定义中，主层瘤动脉指胸主动脉及腹主动脉而非其旁支。诊断必须由专科医生及检验结果证实，检验包括电脑断层扫描，磁共振扫描及磁共振血管造影或心导管检查的证明，并有必要进行紧急修补手术。
6.9.77肌萎缩脊髓侧索硬化后遗症	肌萎缩脊以肌肉无力及萎缩为特征，并有以下情况作为证明：脊髓前角细胞功能失调、可髓侧索硬见的肌肉颤动、痉挛、过度活跃之深层肌腱反射和外部足底反射、影响皮质脊髓束、化后遗症构音障碍及吞咽困难。必须由我们认可的医院专科医生以适当的神经肌肉检查如肌电图（EMG）证实。本疾病必须导致严重的生理功能损坏（由被保险人永久性无法独立完成六项基本日常生活活动中的三项或三项以上作为证明）。
6.9.78严重结核性脑膜炎	严重结核由结核杆菌引起的脑膜和脊膜的非化脓性炎症性疾病。需满足以下全部条件：性脑膜炎1.出现颅内压明显增高，表现头痛、呕吐和视乳头水肿；2.出现部分性、全身性癫痫发作或癫痫持续状态；3.昏睡或意识模糊；4.视力减退、复视和面神经麻痹。
6.9.79严重肠道疾病并发	严重肠道严重肠道疾病或外伤导致小肠损害并发症，本疾病须满足以下所有条件：疾病并发1.至少切除了三分之二小肠；
症	2.完全肠外营养支持三个月以上。
6.9.80瑞氏综合征	瑞氏综合瑞氏综合征是线粒体功能障碍性疾病。导致脂肪代谢障碍，引起短链脂肪酸、血征氨升高，造成脑水肿。主要临床表现为急性发热、反复呕吐、惊厥及意识障碍等等。肝脏活检是确诊的重要手段。瑞氏综合征需由三级医院的儿科专科医生确诊，并符合下列所有条件：1.有脑水肿和颅内压升高的脑脊液检查和影像学检查证据；2.血氨超过正常值的3倍；3.临床出现昏迷，病程至少达到疾病分期第3期。
6.9.81严重骨髓异常增生综合征	严重骨髓严重骨髓异常增生综合征是指符合世界卫生组织（WHO）2008年分型方案中的难异常增生治性贫血细胞减少伴原始细胞增多1（RAEB1）、难治性贫血细胞减少伴原始细胞增综合征多2（RAEB2）、MDS未分类（MDSU）、MDS伴单纯5q，且需满足下列所有条件：1.由我们认可的医院中设有专门血液病专科的公立三级甲等医院，血液病专科的主治级别以上的医师确诊；2.骨髓穿刺或骨髓活检结果支持诊断；3.被保险人已持续接受一个月以上的化疗或已接受骨髓移植治疗。
6.9.82严重面部烧伤	严重面部指烧伤程度为度，且度烧伤的面积达到面部表面积的80或80以上。烧伤
6.9.83严重川崎病	严重川崎是一种血管炎综合征，临床表现为急性发热，皮肤粘膜病损和淋巴结肿大。本病病须经专科医生明确诊断，同时须由血管造影或超声心动图检查证实，满足下列至少一项条件：1.伴有冠状动脉瘤，且冠状动脉瘤于最初急性发病后持续至少180天；2.伴有冠状动脉瘤，且实际接受了对冠状动脉瘤进行的手术治疗。
6.9.84自体造血干细胞移植术	自体造血为治疗造血功能损害或造血系统恶性肿瘤，已经实施了造血干细胞（包括骨髓造干细胞移血干细胞、外周血造血干细胞和脐血造血干细胞）的自体移植手术。该治疗须由本植术公司认可医院的专科医生认为在临床上是必需的。
6.9.85重症手足口病	重症手足由肠道病毒引起的急性传染病，主要症状表现为手、足、口腔等部位的斑丘疹、口病疱疹。经本公司认可医院的专科医生确诊为患有手足口病，并伴有下列三项中的任意一项并发症：1.有脑膜炎或脑炎并发症，且导致意识障碍或瘫痪的临床表现及实验室检查证据；2.有肺炎或肺水肿并发症，且导致呼吸衰竭的临床表现及实验室检查证据；3.有心肌炎并发症，且导致心脏扩大或心力衰竭的临床表现及实验室检查证据。
6.9.86严重哮喘	严重哮喘指一种反复发作的严重支气管阻塞性疾病，经我们认可的专科医生确诊，且必须同时符合下列标准：1.过去两年中曾因哮喘持续状态住院治疗，并提供完整住院记录；2.因慢性过度换气导致胸廓畸形；3.在家中需要医生处方的氧气治疗法；4.持续日常服用口服类固醇激素治疗持续至少六个月。申请理赔时，被保险人年龄必须在年满25周岁之前。
6.9.87骨生长不全症	骨生长不指一种胶原病，特征为骨易碎，骨质疏松和易骨折。该病有4种类型：型、全症型、型、型。只保障型成骨不全的情形。其主要临床特点有：发展迟缓、多发性骨折、进行性脊柱后侧凸及听力损害。型成骨不全的诊断必须根据身体检查，家族史，X线检查和皮肤活检报告资料确诊。本公司承担本项疾病责任不受本合同责任免除中遗传性疾病，先天性畸形、变形或染色体异常的限制。
6.9.88进行性多灶性白质脑病	进行性多是一种亚急性脱髓鞘性脑病，常常发现于免疫缺陷的病人。必须由神经科专科医灶性白质生根据脑组织活检确诊。脑病
6.9.89脊髓小脑变性症	脊髓小脑脊髓小脑变性症为一组以小脑萎缩和共济失调为主要临床特点的疾病。必须符合变性症所有以下条件：1.脊髓小脑变性症必须由医院诊断，并有以下证据支持：（1）影像学检查证实存在小脑萎缩；（2）临床表现存在共济失调、语言障碍和肌张力异常。2.被保险人运动功能严重障碍，自主生活能力完全丧失，无法独立完成六项基本日常生活活动中的三项或三项以上。
6.9.90婴儿进行性脊肌萎缩症	婴儿进行该病是累及脊髓前角细胞及延髓运动核的神经元退行性变性病。在出生后两年内性脊肌萎出现的脊髓和脑干颅神经前角细胞进行性机能障碍，伴随肌肉无力和延髓机能障碍。缩症本公司承担本项疾病责任不受本合同责任免除中遗传性疾病，先天性畸形、变形或染色体异常的限制。
6.9.91多处臂丛神经根性撕脱	多处臂丛由于疾病或意外导致至少两根臂丛神经根性撕脱，所造成的手臂感觉功能与运动神经根性功能完全永久性丧失。该病必须由本公司认可医院的专科医生明确诊断，并且有电撕脱生理检查结果证实。
6.9.92严重甲型及乙型血友病	严重甲型被保险人必须是患上严重甲型血友病（缺乏凝血因子）或严重乙型血友病（缺及乙型血乏IX凝血因子），而凝血因子或凝血因子IX的活性水平少于百分之一。诊断必须友病由本公司认可医院的的血液病专科医生确认。本公司承担本项疾病责任不受本合同责任免除中遗传性疾病、先天性畸形、变形或染色体异常的限制。
6.9.93艾森门格综合征	艾森门格因心脏病导致的严重肺动脉高压及右向左分流。诊断必须由心脏专科医生经超声综合征心动图和心导管检查证实及需符合以下所有标准：1.平均肺动脉压高于40mmHg；2.肺血管阻力高于3mm/L/min（Wood单位）；3.正常肺微血管楔压低于15mmHg；本公司承担本项疾病责任不受本合同责任免除中遗传性疾病，先天性畸形、变形或染色体异常的限制。
6.9.94细菌性脑脊髓膜炎	细菌性脑指因脑膜炎双球菌感染引起脑脊髓膜化脓性病变，且导致永久性神经损害，持续脊髓膜炎180天以上，并且脑脊液检查显示脑膜炎双球菌阳性。永久性神经损害是指由细菌性脑脊髓膜炎引起的耳聋、失明、动眼神经麻痹、瘫痪、脑积水、智力或性情中度以上的损害，且上述症状持续180天以上仍无改善迹象。
6.9.95严重癫痫	严重癫痫本病的诊断须由本公司认可医院的神经科或儿科专科医生根据典型临床症状和脑电图及MRI、PET、CT等影像学检查做出。理赔时必须提供6个月以上的相关病历记录证明被保险人存在经抗癫痫药物治疗无效而反复发作的强直阵挛性发作或癫痫大发作，且已行神经外科手术以治疗反复发作的癫痫。发热性惊厥以及没有全身性发作的失神发作（癫痫小发作）不在本保障范围内。
6.9.96疾病或外伤所致智力障碍	疾病或外因严重头部创伤或疾病造成被保险人智力低常（智力低于常态）。根据智商（IQ），伤所致智智力低常分为轻度（IQ5070）、中度（IQ3550）、重度（IQ2035）和极重度（IQ20）。力障碍智商的检测必须由我们认可的专职心理测验工作者进行，心理测验工作者必须持有由心理测量专业委员会资格认定书。根据被保险人年龄采用对应的智力量表如韦克斯勒智力量表（儿童智力量表或成人智力量表）。必须满足下列全部条件：1.造成被保险人智力低常（智力低于常态）的严重头部创伤或疾病（以入院日期为准）发生在被保险人6周岁以后；2.专科医生确诊被保险人由于严重头部创伤或疾病造成智力低常；3.专职合格心理检测工作者适时做的心理检测证实被保险人智力低常（轻度、中度、重度或极重度）；4.被保险人的智力低常自确认日起持续180天以上。
6.9.97重症幼年型类风湿性关节炎	重症幼年指为了治疗幼年型类风湿性关节炎，实际实施了膝关节或髋关节置换手术。型类风湿幼年型类风湿性关节炎是一种儿童期发病的慢性关节炎，其特点为在高热和系统性关节炎性病征出现数月后发生关节炎。被保险人疾病诊断时年龄必须在年满18周岁之前。
6.9.98原发性脊柱侧弯的矫正手术	原发性脊指被保险人因原发性脊柱侧弯，在本公司认可医院实际实施了对该病的矫正外科柱侧弯的手术。但由于先天性脊柱侧弯以及其他疾病或意外导致的继发性脊柱侧弯而进行的手矫正手术术治疗不属于本保障责任。
6.9.99脊柱裂	脊柱裂指脊椎或颅骨不完全闭合，导致脊髓脊膜突出，脑（脊）膜突出或脑膨出，并至少合并下列异常中的一项：1.大小便失禁；2.部分或完全性下肢瘫痪或畸形等神经学上的异常。但不包括由X线摄片发现的没有合并脊椎脊膜突出或脑（脊）膜突出的隐形脊椎裂。本公司承担本项疾病责任不受本合同责任免除中遗传性疾病，先天性畸形、变形或染色体异常的限制。
6.9.100弥漫性血管内凝血	弥漫性血指血液凝固系统和纤溶系统的过度活动导致微血管血栓形成、血小板及凝血因子管内凝血耗竭和严重出血，需要输注血浆和浓缩血小板进行治疗。
6.9.101血管性痴呆	血管性痴指由缺血性卒中、出血性卒中和造成记忆、认知和行为等脑区低灌注的脑血管疾呆病所致的严重认知功能障碍综合征。被保险人自主生活能力完全丧失，无法独立完成六项基本日常生活活动中的三项或三项以上，日常生活必须持续受到他人监护。导致痴呆的疾病必须明确诊断，并且有完整的临床、实验室和影像学检查结果证实。神经官能症，精神疾病及酒精中毒所致脑损害不在保障范围内。
6.9.102额颞叶痴呆	额颞叶痴指一组以额颞叶萎缩为特征的痴呆综合征，临床以明显的人格、行为改变和认知呆障碍为特征。被保险人自主生活能力完全丧失，无法独立完成六项基本日常生活活动中的三项或三项以上，日常生活必须持续受到他人监护。导致痴呆的疾病必须明确诊断，并且有完整的临床、实验室和影像学检查结果证实。神经官能症，精神疾病及酒精中毒所致脑损害不在保障范围内。
6.9.103路易体痴呆	路易体痴指一组在临床和病理表现上以波动性认知功能障碍、视幻觉和帕金森综合征为临呆床特点，以路易体为病理特征的神经变性疾病。被保险人自主生活能力完全丧失，无法独立完成六项基本日常生活活动中的三项或三项以上，日常生活必须持续受到他人监护。导致痴呆的疾病必须明确诊断，并且有完整的临床、实验室和影像学检查结果证实。神经官能症，精神疾病及酒精中毒所致脑损害不在保障范围内。
6.9.104亚急性硬化性全脑炎	亚急性硬指一种以大脑白质和灰质损害为主的全脑炎。本病的发生是由于缺损型麻疹病毒慢性持续感染所致的一种罕见的致命性中枢神经系统退变性疾病。早期以炎症性病变化性全脑炎为主，晚期主要为神经元坏死和胶质增生，核内包涵体是本病的特征性改变之一。疾病确诊180天后，仍遗留下列一种或一种以上障碍：1.一肢或一肢以上肢体机能完全丧失；2.语言能力或咀嚼吞咽能力完全丧失；3.自主生活能力完全丧失，无法独立完成六项基本日常生活活动中的三项或三项以上。
6.9.105进行性风疹性全脑炎	进行性风指由风疹病毒感染引起的儿童和青少年的慢性脑炎。疾病确诊180天后，仍遗留下列一种或一种以上障碍：疹性全脑炎1.一肢或一肢以上肢体机能完全丧失；2.语言能力或咀嚼吞咽能力完全丧失；3.自主生活能力完全丧失，无法独立完成六项基本日常生活活动中的三项或三项以上。
6.9.106严重大动脉炎	严重大动指经本公司认可医院的心脏或血管外科专科医生确诊的大动脉炎，须满足下列全脉炎部条件：1.红细胞沉降率及C反应蛋白高于正常值；2.超声检查、CTA检查或血管造影检查证实主动脉及其主要分支存在狭窄；3.已经针对狭窄的动脉进行了手术治疗。以上第1至25种疾病的名称和释义为中国保险行业协会制定的重大疾病保险的疾病定义使用规范中的疾病名称和释义。第26种至106种疾病为本公司增加的疾病类型。
6.10住院	住院指被保险人入住本公司认可医院的正式病房进行治疗，自正式办理入院手续起至正式办理出院手续止，不包括入住门诊观察室、家庭病床、挂床及其他不合理的住院。
6.11实际住院天数	实际住院指被保险人在本公司认可医院实际的住院治疗天数，住院满24小时为一天。住天数院期间请假或外出离开医院的当日的住院关爱津贴保险金将不予给付，具体请假或外出日期以医院的记录为准。
6.12保单年度	保单年度从保单生效日或保单生效对应日零时起至下一年度保单生效对应日零时止为一个保单年度。
6.13重大疾病分组	重大疾病本合同所指的重大疾病分为A、B、C、D、E、F六组，具体疾病分组情况如下：分组
6.14本保险实际交纳的保险费	本保险实指您依据本合同已经向本公司交纳的保险费；如本合同发生过减保情形，则实际际交纳的交纳的保险费为扣除每次减保所对应的保险费后的余额；如本合同发生过豁免保险费保险费情形，被豁免的保险费视为您已交纳。
6.15疾病终末期阶段	疾病终末疾病终末期阶段需由专科医生出具诊断证明和提交临床检查证据，证明被保险人期阶段所患疾病同时满足以下两个条件：1.依现有医疗技术无法缓解；2.根据临床医学经验判断被保险人存活期低于六个月。
6.16保单生效对应日	保单生效保单生效日每年的对应日，如果当月无对应的同一日，则以该月最后一日作为对对应日应日。
6.17毒品	毒品指中华人民共和国刑法规定的鸦片、海洛因、甲基苯丙胺（冰毒）、吗啡、大麻、可卡因以及国家规定管制的其他能够使人形成瘾癖的麻醉药品和精神药品，但不包括由医生开具并遵医嘱使用的用于治疗疾病但含有毒品成分的处方药品。
6.18酒后驾驶	酒后驾驶指经检测或鉴定，发生事故时车辆驾驶人员每百毫升血液中的酒精含量达到或超过道路交通法规规定的标准，或公安机关交通管理部门依据道路交通安全法的规定认定为饮酒后驾驶或醉酒后驾驶。
6.19无合法有效驾驶证驾驶	无合法有指下列情形之一：效驾驶证1.没有取得驾驶资格；驾驶2.驾驶与驾驶证准驾车型不相符合的车辆；3.持审验不合格的驾驶证驾驶；4.持学习驾驶证学习驾车时，无教练员随车指导，或不按指定时间、路线学习驾
6.20无有效行驶证	无有效行驶证1.机动车被依法注销登记的；2.未依法按时进行或通过机动车安全技术检验。
6.21机动车	机动车指以动力装置驱动或牵引，供人员乘用或用于运送物品以及进行工程专项作业的轮式车辆。遗传性疾指生殖细胞或受精卵的遗传物质（染色体和基因）发生突变或畸变所引起的疾病，通常具有由亲代传至后代的垂直传递的特征。
6.23	
6.22遗传性疾病先天性畸形、变形或染色体异常	遗传性疾指生殖细胞或受精卵的遗传物质（染色体和基因）发生突变或畸变所引起的疾病，通常具有由亲代传至后代的垂直传递的特征。病先天性畸指被保险人出生时就具有的畸形、变形或染色体异常。先天性畸形、变形和染色形、变形体异常依照世界卫生组织疾病和有关健康问题的国际统计分类（ICD10）确定。或染色体异常
6.24感染艾滋病病毒或患艾滋病	感染艾滋艾滋病病毒指人类免疫缺陷病毒，英文缩写HIV。艾滋病指人类免疫缺陷病毒引病病毒或起的获得性免疫缺陷综合征，英文缩写AIDS。患艾滋病在人体血液或其他样本中检测到艾滋病病毒或其抗体呈阳性，没有出现临床症状或体征的，为感染艾滋病病毒；如同时出现了明显临床症状或体征的，为患艾滋病。永久不可指自疾病确诊或意外伤害发生之日起，经过积极治疗180天后，仍无法通过现有医疗手段恢复。
6.26	
6.25永久不可逆六项基本日常生活活动	永久不可指自疾病确诊或意外伤害发生之日起，经过积极治疗180天后，仍无法通过现有医疗手段恢复。逆六项基本指：日常生活1.穿衣：自己能够穿衣及脱衣；活动2.移动：自己从一个房间到另一个房间；3.行动：自己上下床或上下轮椅；4.如厕：自己控制进行大小便；5.进食：自己从已准备好的碗或碟中取食物放入口中；6.洗澡：自己进行淋浴或盆浴。
