question	answer
1.1合同构成	本保险条款、保险单或其他保险凭证、投保书、与保险合同有关的投保文件、合法有效的声明、批注、批单、其他经投保人与本公司（见9.1）共同认可的与本合同有关的书面协议都是投保人与本公司之间订立的君康福康宝重大疾病保险合同（以下简称为本合同）的构成部分。
1.2合同成立与生效	投保人提出保险申请，本公司同意承保，本合同成立。除另有约定外，自本合同成立、本公司收取首期保险费并签发保险单后次日零时起本合同生效，生效日应载于保险单上。本公司自生效日的零时起开始承担本合同约定的保险责任。本合同生效日以后每年的对应日是保单周年日，如果当月无对应日期，则以该月最后一日作为对应日。保单年度（见9.2）、保险费应交日（见9.3）均依据生效日进行计算。
1.3投保范围	投保人：凡年满18周岁（见9.4），具有完全民事行为能力且对被保险人具有保险利益的人，均可作为本合同的投保人。被保险人：凡出生满28天至60周岁（含）身体健康的人，均可作为本合同的被保险人。
1.4犹豫期	从投保人收到本合同并书面签收或按照本公司要求的其他方式对本合同进行确认之日起的一段时期为犹豫期，该时期不低于十日，具体日数以保险单上所载的为准。在此期间，如投保人认为本合同与投保人的需求不相符，可以解除本合同，本公司将无息退还保险费。（特殊群体（见9.4）客户另有约定的除外）犹豫期内解除合同时，投保人需要填写申请书，并提供本合同及本公司要求的相关资料。自本公司收到投保人申请解除合同的书面申请之日起，本合同即被解除，本公司自本合同生效日起自始不承担保险责任。
2本公司提供的保障	
2.1保险责任	在本合同有效期内，本公司对被保险人负下列保险责任：一、轻症疾病保险金若被保险人于本合同生效或最后一次复效之日起90日内（含第90日）因意外伤害（见9.6）以外的原因，经医院（见9.7）专科医生（见9.8）确诊初次罹患（见9.9）本合同约定的轻症疾病（见9.10）中的一种或多种，本公司按累计已交保险费给付轻症疾病保险金，本合同终止。若被保险人因意外伤害，或于本合同生效或最后一次复效之日起90日后因意外伤害以外的原因，经医院专科医生确诊初次罹患本合同约定的轻症疾病中的一种或多种，本公司按以下约定给付轻症疾病保险金，本合同继续有效：1.首次及第二次发生轻症疾病，每次给付的轻症疾病保险金为本合同的基本保险金额的20；2.第三次及第四次发生轻症疾病，每次给付的轻症疾病保险金为本合同的基本保险金额的30；3.第五次发生轻症疾病，给付的轻症疾病保险金为本合同基本保险金额的50。每种轻症疾病只给付一次轻症疾病保险金，给付后该种轻症疾病保险金责任终止，本合同的轻症疾病保险金累计给付以五次为限。如果被保险人因同一原因或在同一事故中导致其发生本合同所指的两种或两种以上的轻症疾病，本公司仅按一种轻症疾病给付轻症疾病保险金。首次诊断即达到重疾标准时不能同时或追溯轻症疾病保险金责任赔付。二、重大疾病保险金若被保险人于本合同生效或最后一次复效之日起90日内（含第90日）因意外伤害以外的原因，经医院专科医生确诊初次罹患本合同约定的重大疾病（见9.11）中的一种或多种，本公司按累计已交保险费给付重大疾病保险金，本合同终止。若被保险人因意外伤害，或于本合同生效或最后一次复效之日起90日后因意外伤害以外的原因，经医院专科医生确诊初次罹患本合同约定的重大疾病中的一种或多种，本公司按本合同的基本保险金额给付重大疾病保险金，本合同终止。三、身故保险金若被保险人于本合同生效或最后一次复效之日起90日内（含第90日）因意外伤害以外的原因导致身故，本公司按累计已交保险费给付身故保险金，本合同终止。若被保险人身故时未满18岁，且因意外伤害或于本合同生效或最后一次复效之日起90日后因意外伤害以外的原因导致身故，本公司按累计已交保险费的200给付身故保险金，本合同终止。若被保险人身故时已满18岁，且因意外伤害或于本合同生效或最后一次复效之日起90日后因意外伤害以外的原因导致身故，本公司按照本合同的基本保险金额给付身故保险金，本合同终止。四、全残保险金若被保险人于本合同生效或最后一次复效之日起90日内（含第90日）因意外伤害以外的原因导致全残（见9.12），本公司按累计已交保险费给付全残保险金，本合同终止。若被保险人全残时未满18岁，且因意外伤害或于本合同生效或最后一次复效之日起90日后因意外伤害以外的原因导致全残，本公司按累计已交保险费的200给付全残保险金，本合同终止。若被保险人全残时已满18岁，且因意外伤害或于本合同生效或最后一次复效之日起90日后因意外伤害以外的原因导致全残，本公司按照本合同的基本保险金额给付全残保险金，本合同终止。五、疾病终末期保险金若被保险人于本合同生效或最后一次复效之日起90日内（含第90日）因意外伤害以外的原因，经医院专科医生确诊初次达到疾病终末期（见9.13），本公司按累计已交保险费（见9.14）给付疾病终末期保险金，本合同终止。若被保险人经医院专科医生确诊初次达到疾病终末期时未满18岁，且因意外伤害或于本合同生效或最后一次复效之日起90日后因意外伤害以外的原因达到疾病终末期，本公司按累计已交保险费的200给付疾病终末期保险金，本合同终止。若被保险人经医院专科医生确诊初次达到疾病终末期时已满18岁，且因意外伤害或于本合同生效或最后一次复效之日起90日后因意外伤害以外的原因达到疾病终末期，本公司按照本合同的基本保险金额给付疾病终末期保险金，本合同终止。关于上述的重大疾病保险金、身故保险金、全残保险金和疾病终末期保险金四项保险金，本公司仅给付其中一项。六、被保险人轻症疾病豁免保险费若被保险人因意外伤害，或于本合同生效或最后一次复效之日起90日后因意外伤害以外的原因，经医院专科医生确诊初次罹患本合同约定的轻症疾病，本公司将豁免本合同自轻症疾病确诊之日以后的各期保险费，被豁免的保险费视为已交纳，同时本合同继续有效。上述豁免的保险费不包括以下款项：（1）被保险人罹患轻症疾病之日之前所欠交的保险费和利息；（2）续期保险费交费宽限期内应交未交的保险费；（3）保险单上载明的其他保险合同的保险费。
2.2责任免除	因下列情形之一，造成被保险人发生保险事故（见9.15）的，本公司不承担给付保险金的责任：（1）投保人对被保险人的故意杀害、故意伤害；（2）被保险人故意自伤、故意犯罪或者抗拒依法采取的刑事强制措施；（3）被保险人主动吸食或注射毒品（见9.16）；（4）被保险人酒后驾驶（见9.17）、无合法有效驾驶证驾驶（见9.18），或驾驶无有效行驶证（见9.19）的机动车（见9.20）；（5）被保险人感染艾滋病病毒或患艾滋病（见9.21）（本合同所列第33、47种重大疾病除外）；（6）战争、军事冲突、暴乱或武装叛乱（以上行为以政府宣告或认定为准）；（7）核爆炸、核辐射或核污染；（8）遗传性疾病（见9.22），先天性畸形、变形或染色体异常（见9.23）。发生上述第（1）项情形导致被保险人发生保险事故的，本合同效力即行终止，如果投保人选择的是趸交的交费方式，本公司向除投保人以外的其他权利人（见9.24）退还本合同的现金价值。如果投保人选择的是期交的交费方式，且投保人已交足两年以上保险费的，本公司向除投保人以外的其他权利人退还本合同的现金价值。发生上述其他情形导致被保险人发生保险事故的，本合同效力即行终止，本公司向投保人退还本合同的现金价值。
2.3基本保险金额	指投保人与本公司约定的用以计算保险金数额的基数。本合同的基本保险金额由投保人在投保时与本公司约定，并在保险单上载明。若该金额发生变更，则以变更后的金额为准。
2.4未成年人身故利益给付限制	若被保险人为未成年人，因被保险人身故给付的保险金总和不得超过国务院保险监督管理机构规定的限额，身故给付的保险金额总和约定也不得超过前述限额。
2.5保险期间	本合同的保险期间为终身，并在保险单上载明。
3如何申请领取保险金	
3.1受益人	投保人或者被保险人可以指定一人或多人为身故保险金受益人，身故保险金受益人为多人时，可以确定受益顺序和受益份额，如果没有确定受益顺序，各受益人按同一顺序享有受益权；如果没有确定受益份额，各受益人按照相等份额享有受益权。被保险人为无民事行为能力人或限制民事行为能力人的，应当由其监护人指定受益人。投保人或者被保险人可以变更身故保险金受益人并书面通知本公司。本公司收到变更受益人的书面通知并审核通过后，在保险单或其他保险凭证上批注或者附贴批单；变更自本公司在保险单或其他保险凭证上批注或附贴批单之日起产生效力。投保人在指定和变更身故保险金受益人时，必须经过被保险人书面同意。被保险人身故后，有下列情形之一的，身故保险金作为被保险人的遗产，由本公司依照中华人民共和国继承法的规定履行给付保险金的义务：（1）没有指定受益人，或者受益人指定不明无法确定的；（2）受益人先于被保险人身故，没有其他受益人的；（3）受益人依法丧失受益权或者放弃受益权，没有其他受益人的。受益人与被保险人在同一事件中身故，且不能确定身故先后顺序的，推定受益人身故在先。受益人故意造成被保险人死亡、伤残、疾病的，或者故意杀害被保险人未遂的，该受益人丧失受益权。除另有约定外，轻症疾病保险金、重大疾病保险金、全残保险金和疾病终末期保险金的受益人均为被保险人本人。
3.2保险事故通知	投保人、被保险人或受益人应于自其知道或应当知道保险事故发生之日起7日内通知本公司。否则投保人、被保险人或受益人应承担由于通知迟延致使本公司增加的勘查、检验等各项费用，但因不可抗力（见9.25）导致的迟延除外。通知内容包括：事故情况、原因、伤亡情况以及本公司需要了解的其他情况。投保人、被保险人或受益人故意或因重大过失未及时通知，致使保险事故的性质、原因等难以确定的，本公司对无法确定的部分，不承担给付保险金的责任，但本公司通过其他途径已经及时知道或应当及时知道保险事故发生的除外。
3.3保险金申请轻症疾病保险金、重大疾病保险金、疾病终末期保险金申请	在申请保险金时，请按照下列方式办理：由相应受益人作为申请人书面提出保险金给付申请，并提供下列证明和资料：（1）保险合同；（2）受益人的法定身份证明（见9.26）；（3）由医院出具的附有病历、必要病理检验、血液检验及其它科学方法检验报告的疾病诊断书；（4）与确认保险事故的性质、原因、经过等有关的其它证明和资料。
全残保险金申请	由全残保险金受益人作为申请人填写保险金给付申请书，并须提供下列证明和资料：（1）保险合同；（2）受益人的法定身份证明；（3）国家有关机构认可或具有合法资质的伤残鉴定机构出具的被保险人全残鉴定书；（4）与确认保险事故的性质、原因、经过等有关的其它证明和资料。
身故保险金申请	由身故保险金受益人作为申请人填写保险金给付申请书，并须提供下列证明和资料：（1）保险合同；（2）受益人的法定身份证明；（3）国务院卫生行政部门规定的医疗机构或公安部门出具的被保险人死亡证明书或验尸证明；（4）如被保险人为宣告死亡，受益人须提供人民法院出具的宣告死亡判决书；（5）公安部门出具的被保险人户籍注销证明；（6）与确认保险事故的性质、原因、经过等有关的其他证明和资料。保险金作为被保险人遗产时，除上述证明和资料外，被保险人的继承人还必须提供可证明合法继承权的相关权利文件。如果被保险人身故，本公司有权要求司法鉴定机构对保险事故进行鉴定。
被保险人轻症疾病豁免保险费的申请	由被保险人作为申请人书面提出豁免保险费申请，并提供下列证明和资料：（1）保险合同；（2）被保险人的法定身份证明；（3）由医院出具的附有病历、必要病理检验、血液检验及其它科学方法检验报告的疾病诊断书；（4）与确认保险事故的性质、原因、经过等有关的其它证明和资料。
委托他人代为申请保险金	如果委托他人代为申请，除上述证明和资料外，还须提供相关保险金受益人的授权委托书、受托人有效身份证件等相关证明文件。受益人或继承人为限制民事行为能力人或无民事行为能力人时，由其合法监护人代其申请领取保险金，其合法监护人还必须提供受益人或继承人为限制民事行为能力人或无民事行为能力人的证明和监护人具有合法监护权的证明。
补充通知	以上证明和资料不完整的，本公司将及时一次性通知申请人补充提供有关的证明和资料。
特别注意事项	除上述相关证明和资料外，本公司如认为必要，在保险事故发生后可以对被保险人的身体状况进行检查或鉴定。
3.4保险金给付	本公司在收到保险金给付申请书及上述完整齐全的有关证明和资料后，会及时做出核定，对确定属于保险责任的，在与被保险人或受益人达成有关给付保险金数额的协议后十日内，履行给付保险金责任。对不属于保险责任的，自做出核定之日起三日内向被保险人或受益人发出拒绝给付保险金通知书并说明理由。本公司在收到保险金给付申请书及上述完整齐全的有关证明和资料之日起六十日内，对属于保险责任而给付保险金的数额不能确定的，根据已有证明和资料，按可以确定的数额先予以支付；本公司最终确定给付保险金的数额后，给付相应的差额。
3.5保险金申请时效	被保险人或受益人向本公司请求给付身故保险金和全残保险金的诉讼时效期间为五年，自其知道或者应当知道保险事故发生之日起计算。被保险人或受益人向本公司请求给付其他保险金的诉讼时效期间为二年，自其知道或者应当知道保险事故发生之日起计算。
3.6宣告死亡处理	如果被保险人在本合同有效期内下落不明，后经人民法院宣告死亡的，本公司以判决书生效之日为准，按本合同的约定给付身故保险金。如果被保险人在宣告死亡后生还，身故保险金受益人应于知道或应当知道被保险人生还后三十日内向本公司退还已给付的保险金。退还保险金后，本合同的效力由投保人与本公司协商处理。
4如何交纳保险费	
4.1保险费的交纳	本合同的保险费采取趸交、期交两种方式，可选择的期交交费期限为五年、十年、十五年和二十年，按照本公司的相关规定，由投保人和本公司约定并在保险单上载明。在交纳首期保险费后，投保人应当在每个保险费应交日交纳其余各期的保险费。
4.2宽限期	分期支付保险费的，投保人支付首期保险费后，除本合同另有约定外，如果投保人到期未交纳保险费，自保险费应交日的次日起六十日为宽限期。宽限期内发生的保险事故，本公司仍会承担保险责任，但在给付保险金时会扣除投保人欠交的保险费。如果宽限期结束之后投保人仍未交纳保险费，则本合同自宽限期满的次日零时起中止，但本合同另有约定的除外。
5现金价值权益	
5.1现金价值	指保险单所具有的价值，通常体现为解除保险合同时，根据精算原理计算的，由本公司向投保人退还的那部分金额。本合同保单年度末基本保险金额对应的现金价值会在保险单或批注上载明。保单年度中现金价值的金额基于保单年度末现金价值的金额根据合理的方法计算而得，投保人可以向本公司咨询。
5.2保单贷款	在本合同有效期内且在犹豫期之后，如果本合同具有现金价值，经被保险人书面同意，投保人可以向本公司申请贷款，经本公司同意后投保人可办理保单质押贷款。保单贷款的最高金额不超过本合同当时所具有的现金价值净额（见9.27）的80，具体额度需经本公司审批。每次贷款期限最长不超过六个月，贷款利率按投保人申请贷款当时本公司确定的约定利率（见9.28）执行，并在贷款协议中载明。保单贷款期满时，如果投保人未能全部偿还贷款本金及利息，且本合同的现金价值净额大于零，未偿还的贷款本金及利息将构成新一期的保单贷款，贷款期限为6个月，并按本公司最近一次确定的约定利率计息。当本合同的现金价值净额小于或等于零时，本合同的效力中止。保单贷款须填写保单贷款申请书及其他相关文件，并凭保险合同、最后一次交费凭证及投保人的法定身份证明办理。
5.3减保	本合同已交足二年以上保险费且生效二年后，投保人可以申请减保，但减保后的基本保险金额不得低于申请减保时本公司规定的最低标准。减保后，基本保险金额同比例减少，同时，投保人将领取减少部分对应的现金价值。减保后的保险费按下列公式计算：减保后的保险费本次减保前的保险费(1减保比例)本公司按减保后的基本保险金额承担保险责任。
6合同效力的中止及恢复	
6.1效力中止	在本合同效力中止期间，本公司不负保险责任。
6.2效力恢复	本合同效力中止后二年内，投保人可以申请恢复合同效力。因欠交保险费导致本合同效力中止的，经本公司与投保人协商并达成协议，在投保人补交保险费及累积利息次日零时起，本合同效力恢复。累积利息按本合同约定利率计算，但本合同另有约定的除外。因保单贷款导致本合同效力中止的，经本公司与投保人协商并达成协议，在投保人偿还保单贷款、累积利息及其他未还款项次日零时起，本合同效力恢复。累积利息按本合同约定利率计算，但本合同另有约定的除外。自合同效力中止之日起满二年双方未达成协议的，本公司有权解除合同，并向投保人退还本合同宽限期开始前一日的现金价值。
7如何解除保险合同	
7.1合同解除	投保人在犹豫期后，可以书面通知要求解除本合同，并向本公司提供下列证明和资料：（1）保险合同；（2）解除合同申请书；（3）投保人的法定身份证明；（4）本公司要求的其他证明和资料。自本公司收到解除合同申请书之日起，本合同终止。本公司在收到上述证明和资料之日起30日内退还本合同的现金价值。投保人在犹豫期后解除合同会遭受一定的损失。
8其他需要关注的事项	
8.1如实告知	订立本合同或申请恢复本合同效力时，本公司应向投保人明确说明本合同的内容，并可以就投保人、被保险人的有关情况提出询问，投保人应当如实告知。投保人故意或者因重大过失未履行前款规定的如实告知义务，足以影响本公司决定是否同意承保或者提高保险费率的，本公司有权解除本合同。前款规定的合同解除权，自本公司知道有解除事由之日起，超过三十日不行使而消灭。自本合同成立之日起超过二年的，本公司不得解除本合同；发生保险事故的，本公司承担给付保险金的责任。投保人故意不履行如实告知义务的，本公司对于合同解除前发生的保险事故，不承担给付保险金的责任，并不退还保险费。投保人因重大过失未履行如实告知义务，对保险事故的发生有严重影响的，本公司对于合同解除前发生的保险事故，不承担给付保险金的责任，但退还保险费。本公司在本合同订立时已经知道投保人未如实告知的情况的，本公司不得解除本合同；发生保险事故的，本公司承担给付保险金的责任。
8.2年龄确定与错误处理	被保险人的投保年龄按周岁计算。投保人应在投保本保险时将被保险人的真实年龄在投保单上填明，如果发生错误，本公司按照下列规定办理：（1）投保人申报的被保险人年龄不真实，并且其真实年龄不符合本合同约定的年龄限制的，本公司有权在知道有解除事由之日起三十日内解除本合同，并向投保人退还本合同的现金价值，但自本合同成立之日起超过二年的除外。（2）投保人申报的被保险人年龄不真实，致使投保人支付的保险费少于应付保险费的，本公司有权更正并要求投保人补交保险费，或在给付保险金时按照实付保险费与应付保险费的比例支付。（3）投保人申报的被保险人年龄不真实，致使投保人支付的保险费多于应付保险费的，本公司应将多收的保险费无息退还投保人。
8.3未还款项	本公司在给付各项保险金、退还现金价值或返还保险费时，如果投保人有欠交的保险费或其他未还清款项，本公司会在扣除上述欠款及应付利息后给付。应付利息按本条款约定利率计算，但本合同另有约定的除外。
8.4合同内容变更	投保人和本公司可以协商变更本合同的内容。变更本合同的，应当由本公司在保险单或者其他保险凭证上批注或者附贴批单，或者由投保人与本公司订立书面的变更协议。若被保险人身故，则本公司不接受本合同内容的任何变更申请。
8.5联系方式变更	投保人住所、通讯地址或电话等联系方式变更时，应及时以书面形式或双方认可的其他形式通知本公司。投保人未以书面形式或双方认可的其他形式通知的，本公司将按本合同载明的最后住所或通讯地址等联系方式发送有关通知，并视为已送达给投保人。
8.6争议处理	本合同争议的解决方式，由当事人在合同中约定从下列两种方式中选择一种：（1）因履行本合同发生的争议，由当事人协商解决，协商不成的，提交仲裁委员会仲裁；（2）因履行本合同发生的争议，由当事人协商解决，协商不成的，依法向人民法院提起诉讼。
释义	
9	
10	
9.1本公司	君康人寿保险股份有限公司。
9.2保单年度	从保险合同生效日或生效对应日的零时起至下一年度保险合同生效对应日的前一日24时止为一个保单年度。
9.3保险费应交日	保险合同生效日在每年的对应日的前一日。如果当月无对应的同一日，以该月最后一日为对应日。
9.4周岁	以法定有效身份证件中记载的出生日期为计算基础，自出生之日起为零周岁，每经过一年增加一岁，不足一年的不计。
9.5特殊群体	特殊群体主要针对部分年长、残疾、低收入者设定，本公司对特殊群体的认定以各地方保险监管机构的统一规范标准为依据。
9.6意外伤害	指以外来的、突发的、非本意的、非疾病的客观事件为直接且主要原因导致的身体伤害。猝死、自杀以及自伤均不属于意外伤害。
9.7医院	指经国家卫生部门审核的二级或二级以上的综合性医院和专科医院，但不包括作为诊所、康复、联合病房、家庭病床、护理、修养或戒酒、戒毒等医疗机构。该医院必须具有系统的、充分的诊断设备，全套外科手术设备并提供24小时的医疗与护理服务。
9.8专科医生	专科医生应当同时满足以下四项资格条件：（1）具有有效的中华人民共和国医师资格证书；（2）具有有效的中华人民共和国医师执业证书，并按期到相关部门登记注册；（3）具有有效的中华人民共和国主治医师或主治医师以上职称的医师职称证书；（4）在二级或二级以上医院的相应科室从事临床工作三年以上。
9.9初次罹患	指被保险人在等待期后初次患有本合同所指的重大疾病，不包括被保险人在本合同生效前所患或出现的疾病（或其并发症）、症状、体征、生理缺陷、残疾，但本公司在同意承保时或复效时已知晓并书面认可的不在此限。
9.10轻症疾病	
1.极早期恶性肿瘤或者恶性病变	指经组织病理学检查被明确诊断为下列恶性病变，并且接受了相应的治疗。（1）原位癌；（2）相当于Binet分期方案A期程度的慢性淋巴细胞白血病；（3）相当于AnnArbor分期方案I期程度的何杰金氏病；（4）皮肤癌（不包括恶性黑色素瘤及已发生转移的皮肤癌）；（5）TNM分期为T1N0M0期或者更轻分期的前列腺癌。感染艾滋病毒或者患艾滋病期间所患极早期恶性肿瘤或者恶性病变不在保障范围之内。
2.不典型的急性心肌梗塞	指被临床诊断为急性心肌梗塞并接受了急性心肌梗塞治疗，且满足下列全部条件，但未达到本合同所指重大疾病急性心肌梗塞的标准：（1）心肌酶或肌钙蛋白有诊断意义的升高；（2）心电图有损伤性的ST段改变但未出现病理Q波。（3）若被保险人因同一原因导致其同时满足不典型的急性心肌梗塞和冠状动脉介入手术（非开胸手术）的，仅按其中一项给付。
3.轻微脑中风后遗症	指被保险人实际发生了脑血管的突发病变并出现神经系统功能障碍表现，头颅断层扫描（CT）、核磁共振检查（MRI）等影像学检查证实存在对应病灶，确诊为脑出血、脑栓塞或者脑梗塞，在确诊180天后遗留神经系统功能障碍，但未达到本合同所指重大疾病脑中风后遗症的标准。遗留的神经系统功能障碍须满足下列一种或者一种以上障碍：（1）一肢或者一肢以上肢体机能部分丧失，其肢体肌力为级,或者小于级；（2）自主生活能力部分丧失，无法独立完成六项基本日常生活活动中的两项或者两项以上。若被保险人因同一原因导致其满足轻微脑中风后遗症和轻度颅脑手术、植入大脑内分流器的，仅按其中一项给付。
4.微创冠状动脉搭桥术	指确实透过微型的胸壁锁孔（于肋骨之间开一个细小的切口），进行非体外循环下的冠状动脉搭桥手术，以矫正一条或以上冠状动脉狭窄或闭塞。微创进行直接的冠状动脉搭桥手术亦可称锁孔式冠状动脉手术。有关程序为医疗所需及由本公司认可医院的心脏专科医生进行。被保险人已达到本合同所指重大疾病急性心肌梗塞或严重冠心病标准的，本公司不承担本项手术保险责任。本公司对冠状动脉介入手术（非开胸手术）、微创冠状动脉搭桥术和激光心肌血运重建术三项中的其中一项承担保险责任，给付其中一项保险金后，对其他两项轻症疾病保险责任同时终止。
5.冠状动脉介入手术（非开胸手术）	为了治疗明显的冠状动脉狭窄性疾病，首次实际实施了冠状动脉球囊扩张成形术、冠状动脉支架植入术、冠状动脉粥肿斑块切除术或者激光冠状动脉成形术。被保险人已达到本合同所指重大疾病急性心肌梗塞或严重冠心病标准的，本公司不承担本项手术保险责任。本公司对冠状动脉介入手术（非开胸手术）、微创冠状动脉搭桥术和激光心肌血运重建术三项中的其中一项承担保险责任，给付其中一项保险金后，对其他两项轻症疾病保险责任同时终止。
6.激光心肌血运重建术	指患有顽固性心绞痛，经持续药物治疗后无改善，冠状动脉搭桥手术及经皮血管成形手术已失败或者被认为不者被认为不适合。在本公司认可医院内实际进行了开胸手术下或者胸腔镜下的激光心肌血运重建术。被保险人已达到本合同所指重大疾病急性心肌梗塞或严重冠心病标准的，本公司不承担本项手术保险责任。本公司对冠状动脉介入手术（非开胸手术）、微创冠状动脉搭桥术和激光心肌血运重建术三项中的其中一项承担保险责任，给付其中一项保险金后，对其他两项轻症疾病保险责任同时终止。
7.慢性肾功能衰竭	指被保险人因双肾功能慢性不可逆性损害达到肾功能衰竭期，但未达到本合同所指重大疾病终末期肾病（或称慢性肾功能衰竭尿毒症期）的标准。诊断必须满足所有以下标准。（1）GFR25；（2）Scr5mg/dl或442umol/L；（3）持续180天。
8.肾脏切除	因疾病或者意外伤害导致至少单侧肾切除。因捐赠肾脏而所需的肾脏切除不在保障范围内。
9.单个肢体缺失	指一个肢体自腕关节或踝关节近端（靠近躯干端）以上完全性断离，但未达到本合同所指重大疾病多个肢体缺失的标准。因糖尿病导致单足切除导致的单个肢体缺失不在本项保障范围内。
10.病毒性肝炎导致的肝硬化	因肝炎病毒感染的肝脏慢性炎症并发展为肝硬化。理赔时须满足下列全部条件：（1）被保人有感染慢性肝炎病毒的血清学及实验室检查报告等临床证据；（2）必须由本公司认可医院的消化科专科医生基于肝脏组织病理学检查报告、临床表现及病史对肝炎病毒感染导致肝硬化作出明确诊断；（3）病理学检查报告证明肝脏病变按Metavir分级表中属F4阶段或Knodell肝纤维化标准达到4分。由酒精或药物滥用而引起的本疾病不在保障范围内。本公司对病毒性肝炎导致的肝硬化和慢性肝功能衰竭两项中的其中一项承担保险责任，给付其中一项保险金后，对另一项轻症疾病保险责任同时终止。
11.脑垂体瘤、脑囊肿、脑动脉瘤及脑血管瘤	指经头颅断层扫描（CT）、核磁共振检查（MRI）或者其他影像学检查被确诊为下列病变，并实际接受了手术或者放射治疗。（1）脑垂体瘤；（2）脑囊肿；（3）脑动脉瘤、脑血管瘤。本公司对轻微脑中风后遗症、微创颅脑手术和脑垂体瘤、脑囊肿、脑动脉瘤及脑血管瘤三项中的其中一项承担保险责任，给付其中一项保险金后，对其他两项轻症疾病保险责任同时终止。
12.慢性肝功能衰竭	指因慢性肝脏疾病导致肝功能衰竭，但未达到本合同所指重大疾病慢性肝功能衰竭失代偿期的标准。须满足下列任意三个条件：（1）持续性黄疸；（2）腹水；（3）肝性脑病（4）充血性脾肿大伴脾功能亢进或食管胃底静脉曲张。因酗酒或药物滥用导致的肝功能衰竭不在保障范围内。本公司对病毒性肝炎导致的肝硬化和慢性肝功能衰竭两项中的其中一项承担保险责任，给付其中一项保险金后，对另一项轻症疾病保险责任同时终止。
13.单耳失聪指因疾病或者意外伤害导致单耳听力永久不可逆性丧失，未达到重大疾病双耳失	聪的给付标准，但满足以下条件：在500赫兹、1000赫兹和2000赫兹语音频率下，平均听阈大于90分贝，且经纯音听力测试、声导抗检测或者听觉诱发电位检测等证实。被保险人在3周岁之前因疾病导致的单耳失聪不在保障范围内。本公司对单耳失聪、听力严重受损和人工耳蜗植入术三项中的其中一项承担保险责任，给付其中一项保险金后，对其它两项轻症疾病保险责任同时终止。
14.人工耳蜗植入术	指由于耳蜗的永久损害而实际实施了人工耳蜗植入手术。诊断须经专科医生确认在医学上是必要的，且在植入手术之前已经符合下列全部条件：1.双耳持续12个月以上重度感音神经性耳聋；2.使用相应的听力辅助设备效果不佳。本公司对单耳失聪、听力严重受损和人工耳蜗植入术三项中的其中一项承担保险责任，给付其中一项保险金后，对其它两项轻症疾病保险责任同时终止。
15.听力严重受损	指因疾病或意外伤害导致双耳听力永久不可逆性丧失，在500赫兹、1000赫兹和2000赫兹语音频率下，平均听阈大于70分贝，且经纯音听力测试、声导抗检测或听觉诱发电位检测等证实。被保险人申请理赔时年龄必须在三周岁以上，并且提供理赔当时的听力丧失诊断及检查证据。本公司对单耳失聪、听力严重受损和人工耳蜗植入术三项中的其中一项承担保险责任，给付其中一项保险金后，对其它两项轻症疾病保险责任同时终止。
16.视力严重受损	指因疾病或者意外伤害导致双眼视力永久不可逆性丧失，虽然未达到重大疾病双目失明的给付标准，但满足下列条件之一：（1）双眼中较好眼矫正视力低于0.1（采用国际标准视力表，如果使用其他视力表应进行换算）；（2）双眼中较好眼视野半径小于20度。被保险人申请理赔时年龄必须在三周岁以上，并且提供理赔当时的视力丧失诊断及检查证据。本公司对视力严重受损、单目失明和角膜移植三项中的其中一项承担保险责任，给付其中一项保险金后，对其它两项轻症疾病保险责任同时终止。此手术必须在本公司认可医院内由专科医生认为是医疗必须的情况下进行。本公司对视力严重受损、单目失明和角膜移植三项中的其中一项承担保险责任，给付其中一项保险金后，对其它两项轻症疾病保险责任同时终止。
18.单目失明指因疾病或意外伤害导致单眼视力永久不可逆性丧失，患眼须满足下列至少一项条	件：（1）眼球缺失或摘除；（2）矫正视力低于0.02（采用国际标准视力表，如果使用其它视力表应进行换算）；（3）视野半径小于5度。诊断须在本公司认可的医院内由眼科专科医生确认，并且提供理赔当时的视力丧失诊断及检查证据。被保险人申请理赔时年龄必须在三周岁以上，并且提供理赔当时的听力丧失诊断及检查证据。本公司对视力严重受损、单目失明和角膜移植三项中的其中一项承担保险责任，给付其中一项保险金后，对其它两项轻症疾病保险责任同时终止。
19.中度瘫痪指因疾病或者意外伤害导致一肢或一肢以上肢体机能永久完全丧失，且未达到重大	疾病瘫痪的给付标准。肢体机能永久完全丧失，指疾病确诊180天后或意外伤害发生180天后，每肢三大关节中的两大关节仍然完全僵硬，或不能随意识活动。
20.心脏瓣膜介入手术（非开胸手术）	为了治疗心脏瓣膜疾病，实际实施了非开胸的经胸壁打孔内镜手术或者经皮经导管介入手术进行的心脏瓣膜置换或者修复手术。
21.中度阿尔茨海默病	指因大脑进行性、不可逆性改变导致智能严重衰退或丧失，临床表现为明显的认知能力障碍、行为异常和社交能力减退，其日常生活必须持续受到他人监护。须由头颅断层扫描(CT)、核磁共振检查（MRI）或正电子发射断层扫描（PET）等影像学检查证实，且自主生活能力严重丧失，无法独立完成六项基本日常生活活动中的两项，但未达到重大疾病严重阿尔茨海默病的给付标准。以下情况不在保障范围内：（1）存在酒精滥用、药物滥用或获得性免疫缺陷综合征（AIDS）情况下的痴呆；（2）神经官能症和精神疾病。
22.脑损伤	指因头部遭受机械性外力，引起脑重要部位损伤，导致神经系统的功能障碍。须由头颅断层扫描（CT）、核磁共振检查（MRI）或正电子发射断层扫描（PET）等影像学检查证实。头部外伤导致神经系统功能障碍，虽然未达到重大疾病严重脑损伤的给付标准，但是符合以下条件：脑损伤30天后，仍遗留下列一种或一种以上障碍：（1）一肢或一肢以上肢体机能完全丧失；（2）语言能力或咀嚼吞咽能力完全丧失；（3）自主生活能力完全丧失，无法独立完成六项基本日常生活活动中的一项或一项以上。本公司对轻微脑中风后遗症、微创颅脑手术和脑垂体瘤、脑囊肿、脑动脉瘤及脑血管瘤三项中的其中一项承担保险责任，给付其中一项保险金后，对其他两项轻症疾病保险责任同时终止。
23.中度帕金森氏病	是一种中枢神经系统的退行性疾病，临床表现为震颤麻痹、共济失调等。须同时符合下列所有条件，但未达到本合同所指重大疾病严重帕金森病的标准：（1）无法通过药物控制；（2）出现逐步退化客观征状；（3）至少180天无法独立完成六项基本日常生活活动中的二项。继发性帕金森综合征不在保障范围内。
24.全身较小面积度烧伤	指烧伤程度为度，且度烧伤面积为全身体表面积的10或者10以上，但尚未达到20。体表面积根据中国新九分法计算。若被保险人因同一原因导致其同时满足全身较小面积度烧伤、轻度面部烧伤，的，仅按其中一项给付。
25.原发性肺动脉高压	指由于原发性肺动脉高压进行性发展而导致右心室肥厚，已经造成永久不可逆性的体力活动能力受限，达到美国纽约心脏病学会心功能状态分级III级及以上，但尚未达到IV级，且静息状态下肺动脉平均压超过25mmHg，但尚未超过30mmHg。
26.早期运动神经元病	指一组中枢神经系统运动神经元的进行性变性疾病，包括进行性脊肌萎缩症、进行性延髓麻痹症、原发性侧索硬化症、肌萎缩性侧索硬化症。须满足自主生活能力部分丧失，无法独立完成六项基本日常生活活动中的两项或者两项以上的条件。
27.可逆性再生障碍性贫血	指因急性可逆性的骨髓造血功能衰竭而导致贫血、中性粒细胞减少和血小板减少，必须由血液科医生的诊断，且病历资料显示接受了下列任一治疗：（1）骨髓刺激疗法至少一个月；（2）免疫抑制剂治疗至少一个月；（3）接受了骨髓移植。
28.主动脉内手术（非开胸手术）	为了治疗主动脉疾病实际实施了经皮经导管进行的动脉内手术。主动脉指胸主动脉和腹主动脉，不包括胸主动脉和腹主动脉的分支血管。
29.微创颅脑手术	因疾病被保险人确已实施全麻下的颅骨钻孔手术或者经鼻蝶窦入颅手术。因外伤而实施的脑外科手术不在保障术不在保障范围内。
30.糖尿病导致单足截除	因糖尿病引起的神经及血管病变累及足部，为了维持生命在本公司认可医院内已经进行了医疗必须的由足踝或以上位置的单足截除手术，且未达到本合同重大疾病糖尿病导致的双脚截除的赔付标准。切除多只脚趾或因任何其他原因引起的截除术不在保障范围内。
31.中度类风湿性关节炎	根据美国风湿病学院的诊断标准，由风湿科专科医生明确诊断并符合下列所有理赔条件，但未达到本合同所指重大疾病严重类风湿性关节炎的标准：（1）关节广泛受损，并经临床证实出现最少2个下列关节位置严重变形：手部、手腕、肘部、膝部、髋部、踝部、颈椎或脚部；（2）至少180天无法独立完成六项基本日常生活活动中的二项或二项以上。
32.中度重症肌无力	是一种神经与肌肉接头部位传递障碍的自身免疫性疾病，临床特征是局部或全身横纹肌于活动时易于疲劳无力，颅神经眼外肌最易累及，也可涉及呼吸肌、下肢近端肌群以至全身肌肉。该病必须由本公司认可医院的专科医生明确诊断，且疾病确诊180天后，仍然存在自主生活能力部分丧失，无法独立完成六项基本日常生活活动中的二项，但未达到本合同所指重大疾病重症肌无力的标准。
33.中度溃疡性结肠炎	本合同所保障的溃疡性结肠炎是指伴有致命性电解质紊乱的急性暴发性溃疡性结肠炎，病变累及全结肠，表现为严重的血便和系统性症状体征和肠破裂的风险，本疾病的确诊必须经由内窥镜检查证实该疾病侵犯全部结肠及直肠及活体切片检查证实为溃疡性结肠炎。且须经肠胃专科医生连续以系统性免疫抑制剂或免疫调节剂持续治疗最少90天，但未达到本合同所指重大疾病严重溃疡性结肠炎的标准，才符合本保障范围。其他种类的发炎性结肠炎,只发生在直肠的溃疡性结肠炎均不在保障范围内。
34.早期系统性硬皮病	指一种以局限性或弥漫性皮肤增厚和皮肤、血管、内脏器官异常纤维化为特征的结缔组织病。本病须经专科医生明确诊断，未达到本合同所指重大疾病严重系统性硬皮病的标准，并须满足下列所有条件：（1）必须是经由本公司认可医院的风湿学专科医生根据美国风湿病学会（ACR）及欧洲抗风湿病联盟(EULAR)在2013年发布的系统性硬皮病诊断标准确认达到确诊标准（总分值由每一个分类中的最高比重（分值）相加而成，总分9分的患者被分类为系统性硬皮病）。（2）须提供明确的病理活检及自身抗体免疫血清学证据支持。以下情况不在保障范围内：（1）局限性硬皮病（带状硬皮病或斑状损害）（2）嗜酸性筋膜炎（3）CREST综合征
35.早期象皮病	指因丝虫感染导致淋巴管阻塞而造成身体组织出现严重淋巴水肿，但未达到本合同所指重大疾病象皮病的标准。此病症须经本公司认可医院的专科医生根据临床表现和微丝蚴的化验结果确诊。由性接触传染的疾病、创伤、手术后疤痕、充血性心力衰竭或先天性淋巴系统异常引起的淋巴水肿，以及急性淋巴管炎或其他原因引起的淋巴水肿不在保障范围内。
36.心包膜切除术	指为治疗心包膜疾病，已经实施了心包膜切除术，但未达到本合同所指重大疾病严重慢性缩窄型心包炎的标准。手术必须在心脏科医生认为是医学上必需的情况下进行。
37.肺功能衰竭	指因慢性呼吸系统疾病导致呼吸功能衰竭，未达到本合同所指重大疾病慢性呼吸功能衰竭的标准，且诊断必须满足以下所有条件：（1）第一秒末用力呼吸量（FEV1）小于1升；（2）残气容积占肺总量（TLC）的50以上；（3）PaO260mmHg,PaCO250mmHg。
38.植入心脏起搏器	因严重心律失常而确实已经实施永久性心脏起搏器的植入手术。理赔时须提供完整病历资料及手术记录，诊断及治疗均须在本公司认可医院专科医生认为是医疗必须的情况下进行。由于心脏再同步化治疗而实施的植入心脏起博器包括在本项保障范围内。
39.早期原发性心脏病	被诊断为原发性心肌病，并符合下列所有条件，但未达到本合同所指重大疾病严重原发性心肌病的标准：（1）导致心室功能受损，其受损程度达到美国纽约心脏病学会心功能状态分级级（注），或其同等级别。（2）左室射血分数LVEF35。（3）原发性心肌病的诊断必须由本公司认可医院的心脏专科医生确认，并提供心脏超声检查结果报告。本保障范围内的心肌病仅包括扩张型心肌病、肥厚型心肌病及限制型心肌病。继发于全身性疾病或其他器官系统疾病及酒精滥用造成的心肌病变不在保障范围内。注：美国纽约心脏病学会心功能状态分级级是指体力活动明显受限，休息时无症状，轻于日常的活动即可引起充血性心力衰竭的症状。
40.轻度面部烧伤	指烧伤程度为度，且度烧伤的面积达到面部表面积的30或者30以上，但未达到面部表面积的80。若被保险人因同一原因导致其同时满足全身较小面积度烧伤、轻度面部烧伤的，仅按其中一项给付。
41.特定周围动脉疾病的血管介入治疗	指为治疗一条或者一条以上的下动脉狭窄而实施的血管介入治疗：（1）为下肢或者上肢供血的动脉；（2）肾动脉；（3）肠系膜动脉。须满足下列全部条件：（1）经血管造影术证实一条或者一条以上的上述动脉狭窄达到50或者以上；（2）对一条或者一条以上的上述动脉施行了血管介入治疗，如血管成形术及/或者进行植入支架或者动脉瘤清除手术。上述动脉疾病的诊断以及相关治疗的必要性必须由血管疾病的专科医生确定。
42.于颈动脉进行血管成形术或内膜切除术	指根据颈动脉造影检查结果，确诊一条或以上颈动脉存在严重狭窄性病变（至少一支血管管腔直径减少50以上）。本病须经国家机关认可的有合法资质的专科医生明确诊断，同时必须已经采取以下手术以减轻症状：1.确实进行动脉内膜切除术；2.确实进行血管介入治疗，例如血管成形术及/或进行植入支架或动脉粥样瘤清除手术。
43.面部重建手术	确实进行整形或者重建手术（颈部以上的面部构造不完整、缺失或者受损而对其形态及外观进行修复或者重建），同时必须由专科医生认为该面部毁容是需要接受住院治疗，及其后接受该手术，而对该面部毁容所进行的治疗亦是医疗所需。因纯粹整容原因、独立的牙齿修复、独立的鼻骨骨折或者独立的皮肤伤口所进行的手术均受此保障。因酒精或者滥用药物引致的疾病或者紊乱及或者因捐赠肝脏而所需的肝脏手术均不在保障范围内。
45.单侧肺脏切除	因疾病或意外事故实际实施的一侧肺脏切除术。部分切除手术和肺脏捐献引起的手术不在保障范围内。
46.双侧卵巢或睾丸切除术	指为治疗疾病实际接受了经腹部切开或腹腔镜进行的双侧卵巢或睾丸完全切除手术。部分卵巢或睾丸切除不在保障范围。
47.腔静脉过滤器植入术	指为治疗反复肺栓塞发作，抗凝血疗法无效，已经实施了腔静脉过滤器植入术。手术必须在专科医生认为是医学上必需的情况下进行。
48.硬脑膜下血肿手术	为清除或引流因意外导致的血肿，需于头部进行开颅或钻孔手术。开颅或钻孔手术必须在本公司认可医院内由专科医生认为是医疗必须的情况下进行。
49.严重阻塞性睡眠窒息症	须有相关医学范畴的注册专科医生，经多导睡眠监测仪监测明确诊断为严重阻塞性睡眠呼吸暂停综合征（OSA），并必须符合以下两项条件：（1）被保险人必须现正介绍持续气道正压呼吸器（CPAP）之夜间治疗；（2）必须提供睡眠测试的文件证明，显示AHI30及夜间血氧饱和平均值85。
50.因肾上腺皮脂腺瘤切除肾上腺	因肾上腺皮质腺瘤所导致的醛固酮分泌过多而产生的继发性恶性高血压而实际接受了肾上腺切除术治疗。诊断及治疗均须在本公司认可医院内由专科医生认为是医疗必须的情况下进行。
9.11重大疾病	被保险人发生符合以下疾病定义所述条件的疾病，应当由专科医生明确诊断。其中，25种重大疾病定义完全采用了中国保险行业协会制定的重大疾病保险的疾病定义使用规范中的疾病定义，其他为本公司增加的疾病。
1.恶性肿瘤	指恶性细胞不受控制的进行性增长和扩散，浸润和破坏周围正常组织，可以经血管、淋巴管和体腔扩散转移到身体其它部位的疾病。经病理学检查结果明确诊断，临床诊断属于世界卫生组织疾病和有关健康问题的国际统计分类（ICD10）的恶性肿瘤范畴。下列疾病不在保障范围内：(1)原位癌；(2)相当于Binet分期方案A期程度的慢性淋巴细胞白血病；(3)相当于AnnArbor分期方案I期程度的何杰金氏病；(4)皮肤癌（不包括恶性黑色素瘤及已发生转移的皮肤癌）；(5)TNM分期为T1N0M0期或更轻分期的前列腺癌；(6)感染艾滋病病毒或患艾滋病期间所患恶性肿瘤。
2.急性心肌梗塞	指因冠状动脉阻塞导致的相应区域供血不足造成部分心肌坏死。须满足下列至少三项条件：（1）典型临床表现，例如急性胸痛等；（2）新近的心电图改变提示急性心肌梗塞；（3）心肌酶或肌钙蛋白有诊断意义的升高，或呈符合急性心肌梗塞的动态性变化；（4）发病90天后，经检查证实左心室功能降低，如左心室射血分数低于50。
3.脑中风后遗症	指因脑血管的突发病变引起脑血管出血、栓塞或梗塞，并导致神经系统永久性的功能障碍。神经系统永久性的功能障碍，指疾病确诊180天后，仍遗留下列一种或一种以上障碍：（1）一肢或一肢以上肢体机能完全丧失；（2）语言能力或咀嚼吞咽能力完全丧失；（3）自主生活能力完全丧失，无法独立完成六项基本日常生活活动中的三项或三项以上。
4.重大器官移植术或造血干细胞移植术	重大器官移植术，指因相应器官功能衰竭，已经实施了肾脏、肝脏、心脏或肺脏的异体移植手术。造血干细胞移植术，指因造血功能损害或造血系统恶性肿瘤，已经实施了造血干细胞（包括骨髓造血干细胞、外周血造血干细胞和脐血造血干细胞）的异体移植手术。
5.冠状动脉搭桥术（或称冠状动脉旁路移植术）	指为治疗严重的冠心病，实际实施了开胸进行的冠状动脉血管旁路移植的手术。冠状动脉支架植入术、心导管球囊扩张术、激光射频技术及其它非开胸的介入手术、腔镜手术不在保障范围内。
6.终末期肾病（或称慢性肾功能衰竭尿毒症期）	指双肾功能慢性不可逆性衰竭，达到尿毒症期，经诊断后已经进行了至少90天的规律性透析治疗或实施了肾脏移植手术。
7.多个肢体缺失	指因疾病或意外伤害导致两个或两个以上肢体自腕关节或踝关节近端（靠近躯干端）以上完全性断离。
8.急性或亚急性重症肝炎	指因肝炎病毒感染引起肝脏组织弥漫性坏死，导致急性肝功能衰竭，且经血清学或病毒学检查证实，并须满足下列全部条件：（1）重度黄疸或黄疸迅速加重；（2）肝性脑病；（3）B超或其它影像学检查显示肝脏体积急速萎缩；（4）肝功能指标进行性恶化。
9.良性脑肿瘤	指脑的良性肿瘤，已经引起颅内压增高，临床表现为视神经乳头水肿、精神症状、癫痫及运动感觉障碍等，并危及生命。须由头颅断层扫描（CT）、核磁共振检查（MRI）或正电子发射断层扫描（PET）等影像学检查证实，并须满足下列至少一项条件：（1）实际实施了开颅进行的脑肿瘤完全切除或部分切除的手术；（2）实际实施了对脑肿瘤进行的放射治疗。脑垂体瘤、脑囊肿、脑血管性疾病不在保障范围内。
10.慢性肝功能衰竭失代偿期	指因慢性肝脏疾病导致肝功能衰竭。须满足下列全部条件：（1）持续性黄疸；（2）腹水；（3）肝性脑病；（4）充血性脾肿大伴脾功能亢进或食管胃底静脉曲张。因酗酒或药物滥用导致的肝功能衰竭不在保障范围内。
11.脑炎后遗症或脑膜炎后遗症	指因患脑炎或脑膜炎导致的神经系统永久性的功能障碍。神经系统永久性的功能障碍，指疾病确诊180天后，仍遗留下列一种或一种以上障碍：（1）一肢或一肢以上肢体机能完全丧失；（2）语言能力或咀嚼吞咽能力完全丧失；（3）自主生活能力完全丧失，无法独立完成六项基本日常生活活动中的三项或三项以上。
12.深度昏迷指因疾病或意外伤害导致意识丧失,对外界刺激和体内需求均无反应,昏迷程度按	照格拉斯哥昏迷分级（Glasgowcomascale）结果为5分或5分以下，且已经持续使用呼吸机及其它生命维持系统96小时以上。因酗酒或药物滥用导致的深度昏迷不在保障范围内。
13.双耳失聪指因疾病或意外伤害导致双耳听力永久不可逆性丧失，在500赫兹、1000赫兹和	2000赫兹语音频率下，平均听阈大于90分贝，且经纯音听力测试、声导抗检测或听觉诱发电位检测等证实。被保险人申请理赔时年龄必须在三周岁以上，并且提供理赔当时的听力丧失诊断及检查证据。(cid:13)
14.双目失明指因疾病或意外伤害导致双眼视力永久不可逆性丧失，双眼中较好眼须满足下列至	少一项条件：（1）眼球缺失或摘除；（2）矫正视力低于0.02（采用国际标准视力表，如果使用其它视力表应进行换算）；（3）视野半径小于5度。被保险人申请理赔时年龄必须在三周岁以上，并且提供理赔当时的视力丧失诊断及检查证据。
15.瘫痪	指因疾病或意外伤害导致两肢或两肢以上肢体机能永久完全丧失。肢体机能永久完全丧失，指疾病确诊180天后或意外伤害发生180天后，每肢三大关节中的两大关节仍然完全僵硬，或不能随意识活动。
16.心脏瓣膜手术	指为治疗心脏瓣膜疾病，实际实施了开胸进行的心脏瓣膜置换或修复的手术。
17.严重阿尔茨海默病	指因大脑进行性、不可逆性改变导致智能严重衰退或丧失，临床表现为明显的认知能力障碍、行为异常和社交能力减退，其日常生活必须持续受到他人监护。须由头颅断层扫描（CT）、核磁共振检查（MRI）或正电子发射断层扫描（PET）等影像学检查证实，且自主生活能力完全丧失，无法独立完成六项基本日常生活活动中的三项或三项以上。神经官能症和精神疾病不在保障范围内。
18.严重脑损伤	指因头部遭受机械性外力，引起脑重要部位损伤，导致神经系统永久性的功能障碍。须由头颅断层扫描（CT）、核磁共振检查（MRI）或正电子发射断层扫描（PET）等影像学检查证实。神经系统永久性的功能障碍，指脑损伤180天后，仍遗留下列一种或一种以上障碍：（1）一肢或一肢以上肢体机能完全丧失；（2）语言能力或咀嚼吞咽能力完全丧失；（3）自主生活能力完全丧失，无法独立完成六项基本日常生活活动中的三项或三项以上。
19.严重帕金森病	是一种中枢神经系统的退行性疾病，临床表现为震颤麻痹、共济失调等。须满足下列全部条件：（1）药物治疗无法控制病情；（2）自主生活能力完全丧失，无法独立完成六项基本日常生活活动中的三项或三项以上。继发性帕金森综合征不在保障范围内。
20.严重度烧伤	指烧伤程度为度，且度烧伤的面积达到全身体表面积的20或20以上。体表面积根据中国新九分法计算。
21.严重原发性肺动脉高压	指不明原因的肺动脉压力持续性增高，进行性发展而导致的慢性疾病，已经造成永久不可逆性的体力活动能力受限，达到美国纽约心脏病学会心功能状态分级IV级，且静息状态下肺动脉平均压超过30mmHg。
22.严重运动神经元病	是一组中枢神经系统运动神经元的进行性变性疾病，包括进行性脊肌萎缩症、进行性延髓麻痹症、原发性侧索硬化症、肌萎缩性侧索硬化症。须满足自主生活能力完全丧失，无法独立完成六项基本日常生活活动中的三项或三项以上的条件。
23.语言能力丧失	指因疾病或意外伤害导致完全丧失语言能力，经过积极治疗至少12个月（声带完全切除不受此时间限制），仍无法通过现有医疗手段恢复。精神心理因素所致的语言能力丧失不在保障范围内。被保险人申请理赔时年龄必须在三周岁以上，并且提供理赔当时的语言能力丧失诊断及检查证据。
24.重型再生障碍性贫血	指因骨髓造血功能慢性持续性衰竭导致的贫血、中性粒细胞减少及血小板减少。须满足下列全部条件：（1）骨髓穿刺检查或骨髓活检结果支持诊断；（2）外周血象须具备以下三项条件：中性粒细胞绝对值0.510/L；网织红细胞1；血小板绝对值2010/L。
25.主动脉手术	指为治疗主动脉疾病，实际实施了开胸或开腹进行的切除、置换、修补病损主动脉血管的手术。主动脉指胸主动脉和腹主动脉，不包括胸主动脉和腹主动脉的分支血管。动脉内血管成形术不在保障范围内。
26.严重多发性硬化症	指被保险人因脑及脊髓内的脱髓鞘病变而出现神经系统多灶性（多发性）多时相（至少6个月以内有一次以上（不包含一次）的发作）的病变，须由计算机断层扫描（CT）、核磁共振检查（MRI）或正电子发射断层扫描（PET）等影像学检查证实，且已经造成自主生活能力完全丧失，无法独立完成六项基本日常生活活动中的三项或三项以上，持续至少180天。
27.终末期肺病	被保险人患有终末期肺病而出现慢性呼吸功能衰竭，须满足下列全部条件：（1）肺功能测试其FEV1持续低于0.75升；（2）病人缺氧必须广泛而持续地进行输氧治疗；（3）动脉血气分析氧分压低于55mmHg。因外伤而实施的脑外科手术不在保障范围之内。
29.严重I型糖尿病	指因严重的胰岛素缺乏导致的一组糖、脂肪、蛋白质代谢异常综合症，且须依赖外源性胰岛素进行机体的葡萄糖代谢和维持生命。本病须经血胰岛素测定、血C肽测定或尿C肽测定检查证实，且被保险人已经接受了持续的胰岛素治疗180天以上，并须满足下列至少一项条件：(1)并发增殖性视网膜病变；(2)并发心脏病变，并须植入心脏起搏器进行治疗；(3)至少一个脚趾发生坏疽并已实施手术切除。
30.严重类风湿性关节炎	指广泛分布的慢性进行性多关节病变，表现为关节严重变形，侵犯至少三个主要关节（腕关节、肘关节、肩关节、踝关节、膝关节、髋关节）或关节组（如手的多个指间、掌指关节，足的多个足趾、跖趾关节等），并已达到类风湿性关节炎功能分类IV级的永久不可逆性关节功能障碍，且须满足下列全部条件：晨僵；（1）对称性关节炎；（2）类风湿性皮下结节；（3）类风湿因子滴度升高；（4）X线显示严重的关节（软骨和骨）破坏和关节畸形。
31.急性出血坏死性胰腺炎开腹手术	指被保险人因为急性出血坏死性胰腺炎已经接受了外科开腹手术治疗，以进行坏死组织清除、坏死病灶切除或胰腺切除。因饮酒所致的急性出血坏死性胰腺炎或经腹腔镜手术进行的治疗不在保障范围内。
32.侵蚀性葡萄胎（或称恶性葡萄胎）	指异常增生的绒毛组织浸润性生长浸入子宫肌层或转移至其他器官或组织的葡萄胎，并已经进行化疗或手术治疗的。
33.经输血导致的感染艾滋病病毒或者患艾滋病	指被保险人感染艾滋病病毒或者患艾滋病且须满足下列全部条件：（1）因输血而感染；（2）提供输血治疗的输血中心或医院出具的该项输血感染属医疗责任事故的报告，或法院终审判决为医疗责任；（3）受感染的被保险人不是血友病患者。本公司具有获得和使用被保险人的所有血液样本的权利以及能够对这些样本进行独立检验的权利。任何因其他传播方式（包括：性传播或静脉注射毒品）导致感染艾滋病病毒或者患艾滋病不在保障范围内。
34.系统性红斑狼疮并发重度的肾功能损害	指系统性红斑狼疮患者并发狼疮性肾炎而影响和损害肾脏功能。须满足下列全部条件：临床表现须具备以下至少四项条件：蝶形红斑或盘形红斑；光敏感；口鼻腔黏膜溃疡；非畸形性关节炎或多关节痛；胸膜炎或心包炎；神经系统损伤（癫痫或精神症状）；血象异常（白细胞小于4000/l或血小板小于100000/l或溶血性贫血）。检查结果须具备以下至少两项条件：抗dsDNA抗体阳性；抗Sm抗体阳性；抗核抗体阳性；皮肤狼疮带试验（非病损部位）或肾活检阳性；C3低于正常值。狼疮肾炎致使肾功能减弱，内生肌酐清除率低于每分钟30ml。
35.重症肌无力	指一种神经与肌肉接头部位传递障碍的自身免疫性疾病，临床特征是局部或全身横纹肌于活动时易于疲劳无力，颅神经眼外肌最易累及，也可涉及呼吸肌、下肢近端肌群以至全身肌肉。且须满足下列全部条件：(1)经药物、胸腺手术治疗一年以上无法控制病情；(2)自主生活能力完全丧失，无法独立完成六项基本日常生活活动中的三项或三项以上。
36.持续植物人状态	指因疾病或意外伤害导致被保险人躯体反射和自主反射全部丧失的深昏迷，但呼吸和心跳是正常的，此时完全依赖支持疗法（如流质食物、静脉注射营养液等）维持生命的临床状态。且须满足下列全部条件：（1）诊断为植物人状态后并继续维持治疗30天以上；（2）治疗30天前后的脑电图检查均为等电位（完全平坦）。
37.糖尿病导致的双脚截除	因糖尿病引起的神经及血管病变而经本公司认可的医院的内分泌科专科医生建议，由足踝或以上位置截除双脚是维持生命的唯一方法。切除一只或多只脚趾或因任何其他原因引起的截除术并不在保障范围内。
38.严重溃疡性结肠炎	指伴有致命性电解质紊乱的急性暴发性溃疡性结肠炎，病变累及全结肠，表现为严重的血便和系统性症状体征，须根据组织病理学特点诊断，并且被保险人已经接受了全结肠切除和回肠造瘘术。
39.溶血性链球菌引起的坏疽	指包围肢体或躯干的浅筋膜或深筋膜受到溶血性链球菌的感染，病情在短时间内急剧恶化，且已经立刻进行了手术及清创术。最后的诊断必须由微生物或病理学专家进行相关检查后证实。
40.坏死性筋膜炎	坏死性筋膜炎的诊断须满足下列全部条件：（1）符合坏死性筋膜炎的一般临床表现；（2）细菌培养检出致病菌；（3）出现广泛性肌肉及软组织坏死，并导致身体受影响部位功能永久不可逆性丧失。
41.系统性硬皮病	系统性硬皮病（须累及内脏器官），指一种以局限性或弥漫性皮肤增厚和皮肤、血管、内脏器官异常纤维化为特征的结缔组织病。须满足下列至少一项条件：（1）肺脏：肺部病变进而发展为肺间质纤维化和肺动脉高压；（2）心脏：左室腔扩大至少达到正常值上限的120，且左室射血分数持续性低于40；（3）肾脏：肾脏受损导致双肾功能慢性不可逆衰竭，达到尿毒症期。
42.严重克隆病	指一种慢性肉芽肿性肠炎，具有特征性的克隆病病理组织学变化，须由病理学检查结果证实，且已经造成瘘管形成并伴有肠梗阻或肠穿孔。
43.进行性核上性麻痹	指一种隐袭起病、逐渐加重的神经系统变性疾病，且满足如下临床特征：（1）步态共济失调；（2）对称性眼球垂直运动障碍；（3）假性球麻痹（构音障碍和吞咽困难）。
44.非阿尔茨海默病所致严重痴呆	指因阿尔茨海默病以外的脑的器质性疾病造成脑功能衰竭导致永久不可逆性严重痴呆，临床表现为明显的认知能力障碍、行为异常和社交能力减退。被保险人自主生活能力完全丧失，无法独立完成六项基本日常生活活动中的三项或三项以上，日常生活必须持续受到他人监护。导致痴呆的疾病必须明确诊断，并且由完整的临床、实验室和影像学检查结果证实。神经官能症，精神疾病及酒精中毒所致脑损害不在保障范围内。
45.肺泡蛋白质沉积症	指肺泡和细支气管腔内充满不可溶性富磷脂蛋白的疾病，胸部X线呈双肺弥漫性肺部磨玻璃影，病理学检查肺泡内充满有过碘酸雪夫（PAS）染色阳性的蛋白样物质，并且接受了肺灌洗治疗。
46.严重慢性复发性胰腺炎	指有腹痛等典型症状的胰腺炎反复发作，导致胰腺进行性破坏，并导致胰腺功能紊乱而导致严重糖尿病以及营养不良、恶液质。CT检查证实胰腺存在广泛钙化，且必须接受酶替代以及胰岛素替代治疗六个月以上。诊断必须由消化科专科医生确诊。酒精导致的慢性复发性胰腺炎不在保障范围内。
47.因职业关系导致的感染艾滋病病毒或者患艾滋病	被保险人在其常规职业工作过程中遭遇外伤，或职业需要处理血液或其他体液时感染上艾滋病病毒或者患上艾滋病。须满足下列全部条件：（1）感染必须是在被保险人正在从事其职业工作中发生，该职业必须属于下列职业之一；医生和牙科医生、护士、实验室工作人员、医院护工、医生助理和牙医助理、救护车工作人员、助产士。其他职业不在保障范围内。（2）必须提供被保险人在所报事故发生后的5天以内进行的检查报告，该报告必须显示被保险人血液HIV病毒阴性和/或HIV抗体阴性；（3）必须在事故发生后的6个月内证实被保险人体内存在HIV病毒或者HIV抗体，即血液HIV病毒阳性和/或HIV抗体阳性。
48.原发性硬化性胆管炎	指一种胆汁淤积综合征，其特征是肝内、肝外胆道因纤维化性炎症逐渐狭窄，并最终导致完全阻塞而发展为肝硬化。本病须经内镜逆行胰胆管造影等影像学检查证实，并须满足下列全部条件：（1）总胆红素和直接胆红素同时升高，血清ALP200U/L；（2）持续性黄疸病史；（3）出现胆汁性肝硬化或门脉高压。因肿瘤或胆管损伤等继发性的硬化性胆管炎不在保障范围内。
49.肺淋巴管肌瘤病	肺淋巴管肌瘤病是一种弥漫性肺部疾病，主要病理改变为肺间质、支气管、血管和淋巴管内出现未成熟的平滑肌异常增生，同时需满足下列条件：（1）经组织病理学诊断；（2）CT显示双肺弥漫性囊性改变；（3）血气提示低氧血症。
50.象皮病	指末期丝虫病，按国际淋巴学会分级为三度淋巴液肿，其临床表现为肢体非凹陷性水肿伴畸形增大、硬皮症和疣状增生。此病症须经相关专科医生根据临床表现和微丝蚴的化验结果确诊。
51.胰腺移植指因胰腺功能衰竭，已经实施了在全身麻醉下进行的胰腺的异体器官移植手术（供	体必须是人体器官）。单纯胰岛移植、部分胰腺组织或细胞的移植不在保障范围内。
52.严重川崎病	是一种血管炎综合征，临床表现为急性发热，皮肤粘膜病损和淋巴结肿大。本病须经专科医生明确诊断，同时须由血管造影或超声心动图检查证实，满足下列至少一项条件：（1）伴有冠状动脉瘤，且冠状动脉瘤于最初急性发病后持续至少180天；（2）伴有冠状动脉瘤，且实际接受了对冠状动脉瘤进行的手术治疗。
53.肾髓质囊性病	肾髓质囊性病的诊断须同时符合下列要求：（1）肾髓质有囊肿、肾小管萎缩及间质纤维化等病理改变；（2）贫血、多尿及肾功能衰竭等临床表现；（3）诊断须由肾组织活检确定。单独或良性肾囊肿则不在保障范围内。
54.多处臂丛神经根性撕脱	由于疾病或意外导致至少两根臂丛神经根性撕脱，所造成的手臂感觉功能与运动功能完全永久性丧失。该病必须由本公司认可的医院的专科医生确诊，并且有完整的电生理检查结果证实。
55.埃博拉病毒感染	指埃博拉病毒感染导致的烈性传染病，并须满足下列全部条件：（1）实验室检查证实埃博拉病毒的存在；（2）从发病开始有超过30天的进行性感染症状。
56.失去一肢及一眼	因疾病或意外伤害导致单眼视力丧失及任何一肢自腕关节或踝关节近端（靠近躯干端）以上完全性断离。单眼视力丧失指单眼视力永久不可逆性丧失，患眼须满足下列至少一项条件：（1）眼球缺失或摘除；（2）矫正视力低于0.02（采用国际标准视力表，如果使用其它视力表应进行换算）；（3）视野半径小于5度。被保险人在3周岁之前因疾病导致单眼视力丧失不在保障范围内。
57.特发性慢性肾上腺皮质功能减退	指自身免疫性肾上腺炎（既往称：特发性肾上腺皮质萎缩）导致肾上腺萎缩和慢性肾上腺皮质功能减退。须满足下列全部条件：（1）明确诊断，符合所有以下诊断标准；血浆促肾上腺皮质激素(ACTH)水平测定大于100pg/ml；血浆和尿游离皮质醇及尿17羟皮质类固醇、17酮皮质类固醇测定、血浆肾素活性、血管紧张素II和醛固酮测定，显示为原发性肾上腺皮质功能减退症；促肾上腺皮质激素(ACTH)刺激试验显示为原发性肾上腺皮质功能减退症。（2）已经采用皮质类固醇替代治疗180天以上。肾上腺结核、HIV感染或艾滋病、感染、肿瘤所致的原发性肾上腺皮质功能减退和继发性肾上腺皮质功能减退不在保障范围内。
58.严重传染性心内膜炎	是指由感染性微生物引致的心脏内膜炎症，并须符合下列所有准则：（1）血液培植结果呈阳性反应，证明感染性微生物的存在；（2）出现最少中度之心脏瓣膜功能全（即返流部份达百分之二十或以上）或中度之心脏瓣膜狭窄（即心脏瓣面积为正常值的百分之三十或以下），导致传染性心内膜炎；（3）传染性心内膜炎的诊断及瓣膜受损的严重程度必须由心脏病专科医生确定。
59.嗜铬细胞瘤	指肾上腺或嗜铬外组织出现神经内分泌肿瘤，并分泌过多的儿茶酚胺类，需要确实进手术以切除肿瘤。
60.严重自身免疫性肝炎	自身免疫性肝炎是一种原因不明的慢性肝脏的坏死性炎性疾病，机体免疫机制被破坏，产生针对肝脏自身抗原的抗体导致自身免疫反应，从而破坏肝细胞造成肝脏炎症坏死。必须满足下列全部条件：（1）高球蛋白血症；（2）血液中存在高水平的自身免疫抗体，如ANA（抗核抗体）、SMA（抗平滑肌抗体）、抗LKM1抗体或抗SLA/LP抗体；（3）肝脏活检证实免疫性肝炎；（4）临床已经出现腹水、食道静脉曲张和脾肿大等肝硬化表现。
61.疾病或外伤所致智力障碍	因严重头部创伤或疾病造成被保险人智力低常（智力低于常态）。智力低常分为轻度（IQ5070）、中度（IQ3550）、重度（IQ2035）和极重度（IQ20）。智商的检测必须由本公司认可的专职心理测验工作者进行，心理测验工作者必须持有由心理测量专业委员会资格认定书。根据被保险人年龄采用对应的智力量表如韦克斯勒智力量表（儿童智力量表或成人智力量表）。必须满足下列全部条件：（1）造成被保险人智力低常（智力低于常态）的严重头部创伤或疾病（以入院日期为准）发生在被保险人6周岁以后；（2）专科医师确诊被保险人由于严重头部创伤或疾病造成智力低常；（3）专职合格心理检测工作者适时做的心理检测证实被保险人智力低常（轻度、中度、重度或极重度）；（4）被保险人的智力低常自确认日起持续180天以上。
62.自体造血干细胞移植术	为治疗造血功能损害或造血系统恶性肿瘤，已经实施了造血干细胞（包括骨髓造血干细胞、外周血造血干细胞和脐血造血干细胞）的自体移植手术。该治疗须由专科医生认为在临床上是必需的。
63.严重瑞氏综合征	瑞氏综合征是线粒体功能障碍性疾病。导致脂肪代谢障碍，引起短链脂肪酸、血氨升高，造成脑水肿。主要临床表现为急性发热、反复呕吐、惊厥及意识障碍等等。瑞氏综合征需由三级医院的专科医生确诊，并须满足下列全部条件：（1）有脑水肿和颅内压升高的脑脊液检查和影像学检查证据；（2）血氨超过正常值的3倍；（3）临床出现昏迷，病程至少达到疾病分期第3期。
64.严重肠道疾病并发症	严重肠道疾病或外伤导致小肠损害并发症，并须满足下列全部条件：（1）至少切除了三分之二小肠；（2）完全肠外营养支持三个月以上。本项保险责任仅在被保险人18周岁以前提供保障。
65.重症骨髓增生异常综合征	重症骨髓增生异常综合征（Myelodysplasticsyndromes,MDS)是起源于造血干细胞的一组异质性髓系克隆性疾病，特点是髓系细胞发育异常，表现为无效造血、难治性血细胞减少，本合同所指的严重的骨髓异常增生综合征需满足下列所有条件：（1）由设有专门血液病专科的公立三级甲等医院血液病专科的主治级别以上的医师确诊；（2）骨髓涂片检查同时符合发育异常细胞比例10、原始细胞比例15；（3）已接受至少累计三十日的化疗或已接受骨髓移植治疗。化疗日数的计算以被保险人实际服用、注射化疗药物的天数为准。疑似病例不在保障范围之内。
66.严重慢性缩窄型心包炎	由于慢性心包炎症导致心包脏层和壁层广泛瘢痕粘连、增厚和钙化，心包腔闭塞，形成一个纤维瘢痕外壳，使心脏和大血管根部受压，妨碍心脏的舒张。必需经心脏科专科医生明确诊断为慢性缩窄性心包炎，并且已经造成永久不可逆性的体力活动能力受限，达到美国纽约心脏病学会心功能状态分级IV级，并持续180天以上。
67.重症手足口病	由肠道病毒引起的急性传染病，主要症状表现为手、足、口腔等部位的斑丘疹、疱疹。经本公司认可的医疗机构的专科医生确诊为患有手足口病，并伴有下列三项中的任意一项并发症：（1）有脑膜炎或脑炎并发症，且导致意识障碍或瘫痪的临床表现及实验室检查证据；（2）有肺炎或肺水肿并发症，且导致呼吸衰竭的临床表现及实验室检查证据；（3）有心肌炎并发症，且导致心脏扩大或心力衰竭的临床表现及实验室检查证据。
68.严重幼年型类风湿性关节炎	指为了治疗幼年型类风湿关节炎，实际实施了膝关节或髋关节置换手术。幼年型类风湿关节炎是一种儿童期发病的慢性关节炎，其特点为在高热和系统性病征出现数月后发生关节炎。
69.破裂脑动脉瘤夹闭手术	指因脑动脉瘤破裂造成蛛网膜下腔出血，被保险人已经实施了在全麻下进行的开颅动脉瘤夹闭手术。脑动脉瘤（未破裂）预防性手术、颅骨打孔手术、动脉瘤栓塞手术、血管内手术及其他颅脑手术不在本保障范围内。
70.慢性呼吸功能衰竭	慢性肺部疾病导致永久不可逆性的慢性呼吸功能衰竭。慢性呼吸功能衰竭必须明确诊断并满足下列全部条件：（1）休息时出现呼吸困难；（2）动脉血氧分压（PaO2）50mmHg；（3）动脉血氧饱和度（SaO2）80；（4）因缺氧必须接受持续的输氧治疗。
71.严重脊髓灰质炎	脊髓灰质炎是由于脊髓灰质炎病毒感染所致的瘫痪性疾病，临床表现为运动功能损害或呼吸无力。脊髓灰质炎必须明确诊断。本合同仅对脊髓灰质炎造成的神经系统功能损害导致被保险人一肢或一肢以上肢体机能永久完全丧失的情况予以赔付。肢体机能永久完全丧失，指疾病确诊180天后，每肢三大关节中的两大关节仍然完全僵硬，或不能随意识活动。
72.严重冠心病	指经冠状动脉造影检查明确诊断为主要血管严重狭窄性病变，须满足下列至少一项条件：（1）左冠状动脉主干和右冠状动脉中，一支血管管腔堵塞75以上，另一支血管管腔堵塞60以上；（2）左前降支、左旋支和右冠状动脉中，至少一支血管管腔堵塞75以上，其他两支血管管腔堵塞60以上。左前降支的分支血管、左旋支的分支血管及右冠状动脉的分支血管的狭窄不作为本保障的衡量指标。
73.严重肺源性心脏病	指被保人因慢性肺部疾病导致慢性心功能损害造成永久不可逆性的心功能衰竭。心功能衰竭程度达到纽约心脏病学会的心功能分级标准之心功能IV级。被保险人永久不可逆性的体力活动能力受限，不能从事任何体力活动。
74.艾森门格综合征	因心脏病导致的严重肺动脉高压及右向左分流。诊断必须由心脏专科医生经超声心动图和心导管检查证实及需符合以下所有标准：1.平均肺动脉压高于40mmHg；2.肺血管阻力高于3mm/L/min（Wood单位）；3.正常肺微血管楔压低于15mmHg。
75.严重哮喘指一种反复发作的严重支气管阻塞性疾病，经本公司认可的专科医生确诊，且必须	同时符合下列标准：（1）过去两年中曾因哮喘持续状态住院治疗，并提供完整住院记录；（2）因慢性过度换气导致胸廓畸形；（3）在家中需要医生处方的氧气治疗法；（4）持续日常服用口服类固醇激素治疗持续至少六个月。被保险人申请理赔时年龄必须在年满二十五周岁之前。
76.疯牛病	是一种传染性海绵状脑病，临床表现为快速进行性痴呆、肌阵挛和特征性脑电图变化。本病须经三级医院的专科医生根据WHO诊断标准明确诊断，并且被保险人自主生活能力完全丧失，无法独立完成六项基本日常生活活动中的三项或三项以上。疑似病例不在本保障范围内。
77.肌营养不良症	指一组遗传性肌肉变性病变，临床特征为与神经系统无关的骨骼肌肉对称地进行性无力和萎缩。其诊断需满足下列全部条件：（1）肌电图显示典型肌营养不良症的阳性改变；（2）肌肉活检的病理学诊断符合肌营养不良症的肌肉细胞变性坏死等阳性改变；（3）已导致被保险人持续超过三个月无法独立完成六项基本日常生活活动中的三项或三项以上。
78.严重心肌炎	指被保险人因严重心肌炎性病变导致心功能损害造成持续的永久不可逆性的心功能衰竭。必须满足所有以下条件：（1）心功能衰竭程度达到纽约心脏病学会的心功能分级标准之心功能IV级，或左室射血分数低于30；（2）持续不间断180天以上；（3）被保险人永久不可逆性的体力活动能力受限，不能从事任何体力活动。
79.肝豆状核变性	指一种常染色体隐性遗传的铜代谢缺陷病，以不同程度的肝细胞损害、脑退行性病变和角膜边缘有铜盐沉着环为其临床特征，并须满足下列全部条件：（1）典型症状；（2）角膜色素环（KF环）；（3）血清铜和血清铜蓝蛋白降低，尿铜增加；（4）经肝脏活检确诊。
80.严重的III度房室传导阻滞	指心房激动在房室交界区、房室束及其分支内发生阻滞，不能正常地传到心室的心脏传导性疾病，须满足下列所有条件：（1）心电图显示房室搏动彼此独立，心室率50次/分钟；（2）出现阿斯综合征或心力衰竭的表现；（3）必须持续性依赖心脏起搏器维持心脏正常功能，且已经放置心脏起搏器。
81.严重癫痫本病的诊断须由神经科或儿科专科医生根据典型临床症状和脑电图及MRI、PET、CT	等影相学检查做出。理赔时必须提供6个月以上的相关病历记录证明被保险人存在经抗癫痫药物治疗无效而反复发作的强直阵挛性发作或癫痫大发作，且已行神经外科手术以治疗反复发作的癫痫。发热性惊厥以及没有全身性发作的失神发作（癫痫小发作）不在本保障范围内。
82.骨生长不全症	指一种胶原病，特征为骨易碎，骨质疏松和易骨折。该病有4种类型：I型、II型、III型、IV型。只保障III型成骨不全的情形。其主要临床特点有：发展迟缓、多发性骨折、进行性脊柱后侧凸及听力损害。III型成骨不全的诊断必须根据身体检查，家族史，X线检查和皮肤活检报告资料确诊。此手术必须由专科医生认为是医学上必需的情况下进行。
84.细菌性脑脊髓膜炎	指因脑膜炎双球菌感染引起脑脊髓膜化脓性病变，且导致永久性神经损害，持续90天以上，并且脑脊液检查显示脑膜炎双球菌阳性。永久性神经损害是指由细菌性脑脊髓膜炎引起的耳聋、失明、动眼神经麻痹、瘫痪、脑积水、智力或性情中度以上的损害，且上述症状持续90天以上仍无改善迹象。
85.器官移植导致的HIV感染	指因进行器官移植而感染上人类免疫缺陷病毒（HIV），且须满足下列全部条件：（1）在保障起始日或复效日之后，被保险人因治疗必需而实施器官移植，并且因器官移植而感染人类免疫缺陷病毒；（2）提供器官移植治疗的器官移植中心或医院出具该项器官移植感染，属于医疗责任事故的报告，或者法院终审裁定为医疗责任并且不准上诉；（3）提供器官移植治疗的器官移植中心或医院必须拥有合法经营执照；任何因其他传播方式（包括：性传播或静脉注射毒品）导致的HIV感染不在保障范围内。
86.主动脉夹层瘤	是指主动脉壁在受到某些病理因素的破坏后，高速、高压的主动脉血流将其内膜撕裂，以致主动脉腔内的血流通过主动脉内膜的破裂口进入主动脉内壁而形成血肿。被保险人需通过断层扫描（CT）、核磁共振检查（MRI）、磁共振血管检验法（MRA）或血管扫描等检查，并且实施了胸腹切开的直视主动脉手术。
87.胆道重建术	因疾病或胆道损伤导致实际接受涉及胆总管小肠吻合术的胆道重建手术。诊断及治疗均须在本公司认可的医院内由专科医生认为是医疗必须的情况下进行。因胆道闭锁等先天性疾病而导致进行的胆道手术并不在本合同的保障范围取
88.原发性骨髓纤维化	原发性骨髓纤维化为原因不明的骨髓中成纤维细胞增殖，伴有髓外造血，表现为进行性贫血、脾肿大等症状。本病必须根据骨髓的活组织检查和周围血象检查由血液科专科医生明确诊断，并至少符合下列条件中的三项，且符合条件的状态持续180天及以上，并已经实际接受了针对此症的治疗：（1）血红蛋白100g/L；（2）白细胞计数0.510/L；（3）外周血原始细胞1；（4）血小板计数10010/L。任何其它病因导致的继发性骨髓纤维化不在保障范围内。
89.肌萎缩性（脊髓）侧索硬化症	是指持续的神经变性累及脊髓神经及脑干运动神经元，出现肌肉无力、挛缩、肌束颤动及萎缩症状和体征。须经神经专科医师做出明确诊断，且疾病进行性发展已导致不可逆转的永久性神经系统功能障碍。永久性神经系统功能障碍是指以下六项条件中的一项或一项以上：（1）一上肢或双上肢手腕以上部分的完全及永久瘫痪；（2）一下肢或双下肢足踝以上部分的完全及永久瘫痪；（3）四肢机能完全及永久丧失；（4）完全及永久丧失语言能力；（5）完全及永久丧失吞咽能力（吞咽困难），必须永久使用喂饲管；（6）无法独立进行六项日常生活活动即穿衣、移动、行动、卫生、进食、洗澡中三项或三项以上，且上述日常生活活动经过三个月的持续治疗后仍无法完成。
90.湿性年龄相关性黄斑变性	又称为新生血管性年龄相关性黄斑变性或渗出性年龄相关性黄斑变性，发生脉络膜新生血管（CNV）异常生长穿透玻璃膜进入视网膜，新生血管渗漏，渗出、出血及已经出现瘢痕组织。该病必须由荧光素眼底血管造影检查提示黄斑区新生血管及瘢痕组织形成，并且必须由医院的眼科专科医生确诊为湿性年龄相关性黄斑变性。被保险人申请理赔时须提供近3个月内视力改变显示病情恶化的相关检查报告、诊断证明及病历报告。
91.进行性多灶性白质脑病	是一种亚急性脱髓鞘性脑病，常常发现于免疫缺陷的病人。必须根据脑组织活检确诊。
92.严重登革热（出血性登革热）	出现全部四种症状，包括发高烧、出血现象、肝肿大和循环衰竭（登革热休克综合症即符合WHO登革热第III级及第IV级）。出血性登革热的诊断必须由本公司认可医院的专科医生证实。非出血性登革热并不在保障范围内。
93.范可尼综合征	也称Fanconi综合征，指近端肾小管的功能异常引起的一组症候群。须经专科医生诊断，且须满足下列至少三项条件：(1)尿液检查出现肾性糖尿、全氨基酸糖尿或磷酸盐尿；(2)血液检查出现低磷血症、低尿酸血症或近端肾小管酸中毒；(3)出现骨质疏松、骨骼畸形或尿路结石。(4)通过骨髓片、白细胞、直肠黏膜中的结晶分析或裂隙灯检查角膜有胱氨酸结晶。保险人在三周岁之前罹患该疾病，本公司不承担保险责任。
94.肾上腺脑白质营养不良	指一种最常见的过氧化物酶体病，主要累及肾上腺和脑白质，主要表现为进行性的精神运动障碍，视力及听力下降和（或）肾上腺皮质功能低下等。须经专科医生诊断，且已经造成自主生活能力完全丧失，无法独立完成六项基本日常生活活动中的三项或三项以上，持续至少180天。保险人在三周岁之前罹患该疾病，本公司不承担保险责任。
95.婴儿进行性脊肌萎缩症	该病是累及脊髓前角细胞及延髓运动核的神经元退行性变性病。在出生后两年内出现的脊髓和脑干颅神经前角细胞进行性机能障碍，伴随肌肉无力和延髓机能障碍。
96.脊柱裂	指脊椎或颅骨不完全闭合，导致脊髓脊膜突出，脑（脊）膜突出或脑膨出，合并大小便失禁，部分或完全性下肢瘫痪或畸形等神经学上的异常，但不包括由X线摄片发现的没有合并脊椎脊膜突出或脑（脊）膜突出的隐形脊椎裂。
97.脊髓小脑变性症	脊髓小脑变性症为一组以小脑萎缩和共济失调为主要临床特点的疾病。必须符合所有以下条件：（1）脊髓小脑变性症必须由三甲医院诊断，并有以下证据支持a.影像学检查证实存在小脑萎缩；b.临床表现存在共济失调、语言障碍和肌张力异常；（2）被保险人运动功能严重障碍，自主生活能力完全丧失，无法独立完成六项基本日常生活活动中的三项或三项以上。
98.严重的原发性心肌病	指不明原因引起的一类心肌病变，包括原发性扩张型心肌病、原发性肥厚型心肌病及原发性限制型心肌病三种，病变必须已造成事实上心室功能障碍而出现明显的心功能衰竭（指按照美国纽约心脏病学会提出的新功能状态分级的标准判定，心功能状态已达IV级），且有相关住院医疗记录显示IV级心功能衰竭状态已持续至少180日。本病须经专科医生明确诊断。继发于全身性疾病或其他器官系统疾病造成的心肌病变不在保障范围内。
99.永久性脑脊液分流术	指因先天性脑积水（即先天性的脑脊液循环或吸收功能障碍，使脑脊液大量积滞而导致脑室或蛛网膜下腔扩大），而接受的永久性脑脊液分流手术。
100.严重面部烧伤重大疾病定义中所用到的术语定义：	指烧伤程度为度，且度烧伤的面积达到面部表面积的80或80以上。1.六项基本日常生活活动六项基本日常生活活动是指：（1）穿衣：自己能够穿衣及脱衣；（2）移动：自己从一个房间到另一个房间；（3）行动：自己上下床或上下轮椅；（4）如厕：自己控制进行大小便；（5）进食：自己从已准备好的碗或碟中取食物放入口中；（6）洗澡：自己进行淋浴或盆浴。2.肢体机能完全丧失指肢体的三大关节中的两大关节僵硬，或不能随意识活动。肢体是指包括肩关节的整个上肢或包括髋关节的整个下肢。3.语言能力或咀嚼吞咽能力完全丧失语言能力完全丧失，指无法发出四种语音（包括口唇音、齿舌音、口盖音和喉头音）中的任何三种、或声带全部切除，或因大脑语言中枢受伤害而患失语症。咀嚼吞咽能力完全丧失，指因牙齿以外的原因导致器质障碍或机能障碍，以致不能作咀嚼吞咽运动，除流质食物外不能摄取或吞咽的状态。4.永久不可逆指自疾病确诊或意外伤害发生之日起，经过积极治疗180天后，仍无法通过现有医疗手段恢复。5.专科医生专科医生应当同时满足以下四项资格条件：（1）具有有效的中华人民共和国医师资格证书；（2）具有有效的中华人民共和国医师执业证书，并按期到相关部门登记注册；（3）具有有效的中华人民共和国主治医师或主治医师以上职称的医师职称证书；（4）在二级或二级以上医院的相应科室从事临床工作三年以上。6.遗传性疾病指生殖细胞或受精卵的遗传物质（染色体和基因）发生突变或畸变所引起的疾病，通常具有由亲代传至后代的垂直传递的特征。7.先天性畸形、变形和染色体异常指被保险人出生时就具有的畸形、变形或染色体异常。先天性畸形、变形和染色体异常依照世界卫生组织疾病和有关健康问题的国际统计分类（ICD10）确定。
9.12全残	本合同所述全残指下列情形之一：1.双目永久完全失明；2.两上肢腕关节以上或两下肢踝关节以上缺失；3.一上肢腕关节以上及一下肢踝关节以上缺失；4.一目永久完全失明及一上肢腕关节以上缺失；5.一目永久完全失明及一下肢踝关节以上缺失；6.四肢关节机能永久完全丧失；7.咀嚼、吞咽机能永久完全丧失；8.中枢神经系统机能或胸、腹部脏器机能极度障碍，导致终身不能从事任何工作，为维持生命必要的日常生活活动，全需他人扶助的。失明：包括眼球缺失或摘除、或不能辨别明暗、或仅能辨别眼前手动者，最佳矫正视力低于国际标准视力表0.02，或视野半径小于5度，且病程持续超过180天（眼球缺失或摘除不在此限），并由本公司确定的有资格的眼科医师出具医疗诊断证明。关节机能的丧失：指关节永久完全僵硬、或麻痹、或关节不能随意识活动。咀嚼、吞咽机能的丧失：指由于牙齿以外的原因引起器质障碍或机能障碍，以至不能作咀嚼、吞咽运动，除流质食物外不能摄取或吞咽的状态。为维持生命必要之日常生活活动，全需他人扶助：指食物摄取、大小便始末、穿脱衣服、起居、步行、入浴等，皆不能自己为之，需要他人帮助。
9.13疾病终末期	疾病终末期阶段需由专科医生出具诊断证明和提交临床检查证据，证明被保险人所患疾病同时满足以下两个条件：1.依现有医疗技术无法缓解；2.根据临床医学经验判断被保险人存活期低于六个月。
9.14累计已交保险费	指投保人依据本合同已经向公司交纳的保险费；如本合同发生过减保情形，则实际交纳的保险费为扣除每次减保所对应的保险费后的余额。
9.15保险事故	指本合同约定的保险责任范围内的事故。
9.16毒品	指鸦片、海洛因、甲基苯丙胺（冰毒）、吗啡、大麻、可卡因以及索赔当时政府规定管制的其他能够使人形成瘾癖的麻醉药品和精神药品。
9.17酒后驾驶	指经检测或鉴定，发生事故时车辆驾驶人员每百毫升血液中的酒精含量达到或超过一定的标准，公安机关交通管理部门依据道路交通安全法的规定认定为饮酒后驾驶或醉酒后驾驶。
9.18无合法有效驾驶证驾驶	指下列情形之一：（1）没有驾驶证驾驶；（2）驾驶与驾驶证准驾车型不相符合的车辆；（3）驾驶员持审验不合格的驾驶证驾驶；（4）未经公安交通管理部门同意，持未审验的驾驶证驾驶；（5）持学习驾驶证学习驾车时，无教练员随车指导，或不按指定时间、路线学习驾车；（6）公安交通管理部门规定的其他无有效驾驶证驾驶的情况。
9.19无有效行驶证	指下列情形之一：（1）没有机动车行驶证；（2）未在法律规定期限内按时进行或通过安全技术检验。
9.20机动车	指以动力装置驱动或者牵引，上道路行驶的供人员乘用或用于运送物品以及进行工程专项作业的轮式车辆。
9.21感染艾滋病病毒或患艾滋病	艾滋病病毒指人类免疫缺陷病毒，英文缩写为HIV。艾滋病指人类免疫缺陷病毒引起的获得性免疫缺陷综合征，英文缩写为AIDS。在人体血液或其他样本中检测到艾滋病病毒或其抗体呈阳性，没有出现临床症状或体征的，为感染艾滋病病毒；如果同时出现了明显临床症状或体征的，为患艾滋病。
9.22遗传性疾病	指生殖细胞或受精卵的遗传物质（染色体和基因）发生突变（或畸变）所引起的疾病，通常具有由亲代传至后代的垂直传递的特征。
9.23先天性畸形、变形或染色体异常	指被保险人出生时就具有的畸形、变形或染色体异常。先天性畸形、变形和染色体异常依照世界卫生组织疾病和有关健康问题的国际统计分类（ICD10）确定。
9.24其他权利人	其他权利人按照被保险人、被保险人继承人的顺序确定。
9.25不可抗力	指不能预见、不能避免、不能克服的客观情况。
9.26法定身份证明	指依据法律规定，由有权机构制作颁发的证明身份的证件、文件等，如：居民身份证、户口簿、护照、军人证等。
9.27现金价值净额	指现金价值在扣除尚未偿还的保单贷款、欠交的保险费、累积利息和其它未还款项后的余额。
9.28约定利率	本合同所列明的利率按本公司每年参照一年期流动资金贷款法定利率向上浮动1后宣布的利率计算。
