question	answer
1.2.2身故或全残保险金	被保险人在等待期后至年满18周岁的保单周年日以前身故或者全残，百年人寿按本合同累计已交保险费（无息）的3倍给付身故或全残保险金，本合同效力终止。被保险人在等待期后且年满18周岁的保单周年日以后（含当日）身故或者全残，百年人寿按本合同约定的基本保额给付身故或全残保险金，本合同效力终止。
1.2.3重大疾病保险金一、首次重大疾病保险金：	被保险人在等待期以后经百年人寿认可的医院首次确诊初次患上一种或多种本合同约定的重大疾病（100种重大疾病），百年人寿按本合同约定的基本保额给付重大疾病保险金，给付后该种重大疾病对应组别的重大疾病保险金责任效力终止。同时，本合同现金价值降低为零。二、第二次重大疾病保险金：在百年人寿已按本合同的约定给付首次重大疾病保险金的情况下，若被保险人自首次重大疾病确诊之日起满180日后，初次发病并经百年人寿认可的医院确诊首次患上本合同约定的除首次重大疾病所属组别以外其他组别中的重大疾病（无论一种或多种），百年人寿将按本合同基本保额的150给付第二次重大疾病保险金，给付后该种重大疾病对应组别的重大疾病保险金责任效力终止。三、第三次重大疾病保险金：在百年人寿已按本合同的约定给付首次重大疾病保险金和第二次重大疾病保险金的情况下，若被保险人自第二次重大疾病确诊之日起满180日后，初次发病并经百年人寿认可的医院确诊首次患上本合同约定的除首次重大疾病和第二次重大疾病所属组别以外其他组别中的重大疾病（无论一种或多种），百年人寿将按本合同基本保险金额的250给付第三次重大疾病保险金，本合同效力终止。若百年人寿已按上述约定给付首次重大疾病保险金，则轻症疾病保险金、中症疾病保险金、身故或全残保险金的保险责任均终止，百年人寿仅继续承担重大疾病保险金的保险责任。上述重大疾病保险金与本合同的身故或全残保险金二者不可兼得，即若百年人寿给付其中任何一项保险金，则其余保险金将不再给付。若被保险人在申请理赔时符合重大疾病保险金责任或身故或全残保险金责任中的一种或多种，同时又符合轻症疾病保险金责任或中症疾病保险金责任中的一种或多种，百年人寿仅按照重大疾病保险金责任或身故或全残保险金责任中的一种保险责任进行给付。本合同约定的中症疾病（20种中症疾病），百年人寿按本合同基本保额的50给付中症疾病保险金，每种中症疾病只给付一次中症疾病保险金，给付后该种中症疾病保险金责任效力终止。本合同的中症疾病保险金累计给付以两次为限，本合同的基本保额不变，本合同继续有效。若被保险人在申请理赔时既符合中症疾病保险金责任又符合轻症疾病保险金责任，百年人寿仅按照中症疾病保险金责任进行保险金给付。本合同约定的轻症疾病（35种轻症疾病），百年人寿每次按本合同基本保额的一定比例给付轻症疾病保险金，每种轻症疾病只给付一次轻症疾病保险金，给付后该种轻症疾病保险金责任效力终止。本合同的轻症疾病保险金累计给付以三次为限，每次的给付比例分别为30、35、40，本合同的基本保额不变，本合同继续有效。
1.2.6重大疾病、中症疾病或轻症疾病豁免保险费	给付重大疾病、中症疾病或轻症疾病保险金后，百年人寿将豁免本合同的重大疾病、中症疾病或轻症疾病确诊日后的下一保单年度及以后余下各期的保险费，本项保险责任效力终止。
不保什么	
2.1责任免除	因下列情形之一，导致被保险人发生保险事故的，百年人寿不承担给付保险金的责任：（1）投保人对被保险人的故意杀害、故意伤害；（2）被保险人故意自伤、故意犯罪或抗拒依法采取的刑事强制措施；（3）被保险人在本合同成立或合同效力最后恢复之日起二年内自杀，但被保险人自杀时为无民事行为能力人的除外；（4）被保险人服用、吸食或注射毒品或未遵医嘱使用管制药品；（5）被保险人酒后驾驶机动车、无合法有效驾驶证驾驶机动车或驾驶无有效行驶证的机动车；（6）战争、军事冲突、恐怖活动、暴乱、武装叛乱、核爆炸、核辐射或核污染；（7）被保险人感染艾滋病病毒或患艾滋病期间（导致被保险人身故的除外、发生本合同中约定的疾病除外）；（8）遗传性疾病，先天性畸形、变形或染色体异常（导致被保险人身故的除外、发生本合同中约定的疾病除外）。发生上述第（1）项情形导致被保险人身故的，本合同效力终止。已交足2年以上保险费的，百年人寿向被保险人的继承人退还本合同当时的现金价值。发生上述第（1）项情形导致被保险人发生身故以外保险事故的，本合同效力终止。已交足2年以上保险费的，百年人寿向被保险人退还本合同当时的现金价值。发生上述第（2）（8）项情形导致被保险人发生保险事故的，本合同效力终止，百年人寿向您退还本合同当时的现金价值。
2.2其他免责条款	除以上2.1责任免除外，本合同中还有其他免除百年人寿责任的条款，详见背景突出显示的内容。
如何支付保险费	
3.1保险费的交纳	本合同的交费频次和交费期间由您和百年人寿约定并在保险单上载明。分期支付保险费的，在交纳首期保险费后，您应当按照约定，在每个保险费约定交纳日交纳其余各期的保险费。
3.2宽限期	您交纳首期保险费后，如果您以后到期未交纳保险费，自保险费应交日起60日内为宽限期。宽限期内发生的保险事故，百年人寿仍会承担保险责任，但在给付保险金时会扣除您欠交的保险费。如果您在宽限期结束之后仍未交纳当期保险费，则本合同自宽限期满的次日零时起效力中止，但本合同另有约定的除外。
如何领取保险金	
4.1受益人	您或者被保险人可以指定一人或多人为身故保险金受益人，身故保险金受益人为多人时，可以确定受益人顺序和受益份额，如果没有确定份额，各受益人按照相等份额享有受益权。被保险人为无民事行为能力人或限制民事行为能力人的，可以由其监护人指定受益人。您或者被保险人可以变更身故保险金受益人并书面通知百年人寿。百年人寿收到变更受益人的书面通知后，将及时在保险单上批注或附贴批单。您在指定或变更身故保险金受益人时，必须经过被保险人书面同意。被保险人身故后，遇有下列情形之一的，保险金作为被保险人的遗产，由百年人寿依照中华人民共和国继承法的规定履行给付保险金的义务：（1）没有指定受益人，或者受益人指定不明无法确定的；（2）受益人先于被保险人身故，没有其他受益人的；（3）受益人依法丧失受益权或者放弃受益权，没有其他受益人的。受益人与被保险人在同一事件中身故，且不能确定身故先后顺序的，推定受益人身故在先。受益人故意造成被保险人身故、伤残、疾病的，或者故意杀害被保险人未遂的，该受益人丧失受益权。除另有约定外，身故保险金以外的保险金的受益人为被保险人本人。
4.2保险事故通知	请您、被保险人、受益人或其他有权领取保险金的人在知道保险事故发生之日起10日内通知百年人寿，否则您、被保险人、受益人或其他有权领取保险金的人需承担由于延迟通知致使百年人寿增加的勘查、检验等费用，因不可抗力导致的通知延迟除外。如果您、被保险人、受益人或其他有权领取保险金的人故意或者因重大过失未及时通知百年人寿，致使保险事故的性质、原因、伤害程度等难以确定的，百年人寿对无法确定的部分，不承担给付保险金的责任，但百年人寿通过其他途径已经及时知道或者应当及时知道保险事故发生或者虽未及时通知但不影响百年人寿确定保险事故的性质、原因、损失程度的除外。
4.3保险金申请	申请各项保险金时，申请人应提供相关证明文件和资料。
4.3.1身故保险金申请申请人申请身故保险金时，应提供下列证明文件和资料：	（1）理赔申请书；（2）保险合同；（3）申请人的法定有效身份证明及关系证明；（4）国家卫生行政部门认定的医疗机构、公安部门或其他相关机构出具的被保险人死亡证明；（5）申请人所能提供的与确认保险事故的性质、原因等有关的其他证明和资料。保险金作为被保险人的遗产时，必须提供可证明合法继承权的相关权利文件。
4.3.2全残保险金申请申请人申请全残保险金时，应提供下列证明文件和资料：	（1）理赔申请书；（2）保险合同；（3）被保险人的法定有效身份证明；（4）申请人的法定有效身份证明及关系证明；（5）百年人寿认可的司法鉴定机构根据本合同关于全残的约定所出具的残疾程度鉴定书；（6）申请人所能提供的与确认保险事故的性质、原因、伤害程度等有关的其他证明和资料。
4.3.3重大疾病保险金、中症疾病保险金、轻症疾病保险金及重大疾病、中症疾病或轻症疾病豁免保险费申请	申请人申请重大疾病保险金、中症疾病保险金、轻症疾病保险金及重大疾病、中症疾病或轻症疾病豁免保险费时，应提供下列证明文件和资料：（1）理赔申请书；（2）保险合同；（3）被保险人法定有效身份证明；（4）申请人的法定有效身份证明及关系证明；（5）能够证明符合约定重大疾病、中症疾病、轻症疾病定义的百年人寿认可的医院出具的医学诊断书、医疗病历、检查报告以及其他医学证明文件或司法鉴定机构出具的法医鉴定报告；（6）申请人所能提供的与确认保险事故的性质、原因等有关的其他证明和资料。
4.3.4委托他人代为申请	若申请人委托他人代为申请保险金，受委托人还应提供申请人亲笔签字的授权委托书、受委托人的法定有效身份证明等相关证明文件。
4.3.5提供补充材料	以上保险金申请的证明和资料不完整的，百年人寿将一次性书面通知申请人补充提供有关的证明和资料。
4.4保险金给付	（1）百年人寿在收到保险金给付申请书及合同约定的证明和资料后，将在5日内作出核定；情形复杂的，在30日内作出核定，但合同另有约定的除外。百年人寿应当将核定结果通知被保险人或者受益人；对属于保险责任的，在与被保险人或者受益人达成给付保险金的协议后10日内，履行给付保险金义务。本合同对给付保险金的期限有约定的，百年人寿应当按照约定履行给付保险金义务。（2）百年人寿未及时履行前款规定义务的，除支付保险金外，应当赔偿被保险人或者受益人因此受到的损失。（3）百年人寿依照前款的规定作出核定后，对不属于保险责任的，应当自作出核定之日起3日内向被保险人或者受益人发出拒绝给付保险金通知书，并说明理由。（4）百年人寿自收到给付保险金的请求和有关证明、资料之日起60日内，对给付保险金的数额不能确定的，应当根据已有证明和资料可以确定的数额先予支付；百年人寿最终确定给付保险金的数额后，应当支付相应的差额。
4.5法院宣告死亡的处理	如果被保险人在本合同有效期内失踪，而且被法院宣告死亡，百年人寿以判决书宣告之日为准，按本合同的约定给付身故保险金。如果被保险人在宣告死亡后重新出现或者确知其没有死亡，受益人或者其他领取保险金的人应于知道或应当知道之日起30日内，向百年人寿退还已收取的保险金。
4.6诉讼时效	申请人向百年人寿申请给付身故保险金的诉讼时效期间为5年，自其知道或应当知道保险事故发生之日起计算。申请人向百年人寿申请给付身故保险金以外的其他保险金的诉讼时效期间为2年，自其知道或应当知道保险事故发生之日起计算。
如何退保	
5.1犹豫期	自您签收本合同之日起享有15日的犹豫期。在此期间，请您认真审视本合同。如果您确定本合同与您的需求不相符，您可以书面提出解除本合同申请，您应将本合同、保险费发票原件以及您所能提供的其他与解除合同有关的材料提交给百年人寿。自您书面申请解除合同之日起，本合同正式解除，百年人寿自本合同生效之日起自始不承担保险责任，但无息退还您所交纳的保险费。
5.2您解除合同的手续	您在犹豫期后，可以书面通知要求解除本合同，并向百年人寿提供下列证明和资料：（1）保险合同原件或其他保险凭证；（2）解除合同申请书；（3）您的法定有效身份证明。自您书面申请解除合同之日零时起，本合同效力终止。百年人寿自接到上述证明文件和资料后30日内向您退还本合同的现金价值。您在犹豫期后解除合同会遭受一定损失。
还有哪些权益	
6.1保单贷款	若本合同有效且具有现金价值，您可以通过书面形式向百年人寿申请贷款。贷款金额最高不超过申请时现金价值净额的80。此外，每次贷款金额不得低于该次申请时百年人寿规定的最低金额，并且每次贷款期限最长不超过6个月。贷款利率按本合同约定利率计算，您可随时全部或部分偿还贷款本息。当未还贷款本息加上其他各项欠款达到本合同现金价值时，从次日零时起，本合同效力中止。
7.1合同构成	本合同是您与百年人寿约定保险权利义务关系的协议，包括本保险条款、保险单或其他保险凭证、投保书副本、与本合同有关的投保文件、合法有效的声明、批注、批单及其他您与百年人寿共同认可的书面协议。若上述构成本合同的文件正本需留百年人寿存档，则其复印件或电子影像印刷件亦视为本合同的构成部分，其效力与正本相同；若复印件或电子影像印刷件的内容与正本不同时，则以正本为准。您交付首期保险费，百年人寿核保通过并签发保险单。合同生效日期在保险单上载明。百年人寿承担的保险责任从载于保险单上的生效日零时开始。
7.3合同效力中止与恢复	在本合同效力中止期间，百年人寿不承担保险责任。本合同效力中止后2年内，您可以申请恢复合同效力。您应填写复效申请书，百年人寿会要求您提供被保险人的健康声明书、体检报告书及其他相关证明文件，百年人寿会对材料进行审核，做出是否同意复效的决定。经双方达成复效协议，自您补交保险费及利息（按本合同约定利率计算）和其他未还款项的次日零时起，合同效力恢复。自本合同效力中止之日起满2年双方未达成复效协议的，本合同效力终止，百年人寿向您退还本合同的现金价值。
7.4合同效力终止	有下列情况之一时，本合同的效力终止：（1）被保险人身故或全残；（2）本合同满期、撤销、解除、退保；（3）本合同效力中止后未复效；（4）本合同规定的其他合同效力终止的情形。本合同效力终止后，除另有规定外，百年人寿不退还本合同的现金价值或已交的保险费。
7.5年龄性别错误	您在申请投保时，应将与法定有效身份证明相符的被保险人的出生日期和性别在投保书上填明，如果发生错误按照下列方式办理：（1）您申报的被保险人年龄不真实，并且其真实年龄不符合本合同约定投保年龄限制的，在保险事故发生之前百年人寿有权解除合同，并向您退还本合同现金价值。百年人寿行使合同解除权适用本合同7.6明确说明与如实告知中合同解除权限制的规定。（2）您申报的被保险人年龄或性别不真实，致使您实交保险费少于应交保险费的，百年人寿有权更正并要求您补交保险费。若已经发生保险事故，百年人寿在给付保险金时按实交保险费和应交保险费的比例给付。（3）您申报的被保险人年龄或性别不真实，致使您实交保险费多于应交保险费的，百年人寿会将多收的保险费无息退还给您。
7.6明确说明与如实告知	订立本合同时，百年人寿会向您明确说明本合同的条款内容，特别是免除责任条款内容。百年人寿会就您、被保险人或受益人的有关情况提出书面询问，您应当如实告知。如果您故意或因重大过失不履行如实告知义务，足以影响百年人寿决定是否同意承保或者提高保险费率的，百年人寿有权解除本合同。对于故意不履行如实告知义务的，百年人寿对本合同解除前发生的保险事故，不承担给付保险金的责任，并不退还保险费。因重大过失未履行如实告知义务，对保险事故的发生有严重影响的，百年人寿对本合同解除前发生的保险事故，不承担给付保险金的责任，但退还保险费。上述合同解除权自百年人寿知道有解除事由之日起，经过30日不行使而消灭。自本合同成立之日起超过2年的，百年人寿不得解除合同；发生保险事故的，百年人寿承担给付保险金的责任；百年人寿在合同订立时已经知道未如实告知的情况的，百年人寿不得解除合同；发生保险事故的，百年人寿承担给付保险金的责任。
7.7未还款项	百年人寿在给付各项保险金、退还现金价值或返还保险费时，如果您有欠交的保险费（含宽限期内欠交的保险费）、未偿还的保单贷款及利息或其他未还清款项，百年人寿会在扣除上述欠款及应付利息后给付。应付利息按本合同约定利率计算，但本合同另有约定的除外。
7.8合同内容变更	在本合同有效期内，经与百年人寿协商一致，您可以变更本合同的有关内容。变更本合同的，应当由百年人寿在保险单或者其他保险凭证上批注或者附贴批单，或者由您与百年人寿订立变更的书面协议。若被保险人身故，百年人寿不接受本合同任何内容（包括本合同的权益转让及身故保险金受益人变更等）的变更申请。
7.9地址变更	为了保障您的合法权益，您的住所或通讯地址变更时，请及时以书面形式或双方认可的其他形式通知百年人寿。若您未以书面形式或双方认可的其他形式通知百年人寿，百年人寿按本合同载明的最后住所或通讯地址发送的有关通知，均视为已送达给您。
7.10争议处理	本合同履行过程中，双方发生争议不能协商解决的，可以达成仲裁协议通过仲裁解决，也可以依法向人民法院起诉。
重大疾病	
8.1重大疾病范围	本合同所指的重大疾病在本合同中有确定的含义，不仅包括部分一般意义上的重大疾病，还包括某些重大手术，本合同所指的重大疾病可能与临床医学所指的重大疾病在概念和范围上有所不同，百年人寿将在本合同重大疾病定义中详细列明，您投保本合同即表明认可并遵从本合同中对重大疾病的定义。
8.2重大疾病定义	本合同所指重大疾病，是被保险人发生经百年人寿认可的医院的专科医生明确诊断，符合以下定义所述条件的疾病、疾病状态或手术，共100种。（重大疾病定义中的第8.2.1至8.2.25项采用了中国保险行业协会发布的重大疾病保险的疾病定义使用规范中的疾病定义，如中国保险行业协会或保险监管机关对重大疾病保险的疾病定义进行调整，百年人寿会相应调整。）重大疾病分组、名称及定义如下：
8.2.1恶性肿瘤	指恶性细胞不受控制的进行性增长和扩散，浸润和破坏周围正常组织，可以经血管、淋巴管和体腔扩散转移到身体其它部位的疾病。经病理学检查结果明确诊断，临床诊断属于世界卫生组织疾病和有关健康问题的国际统计分类（ICD10）的恶性肿瘤范畴。下列疾病不在本保障范围内：（1）原位癌；（2）相当于Binet分期方案A期程度的慢性淋巴细胞白血病；（3）相当于AnnArbor分期方案I期程度的何杰金氏病；（4）皮肤癌（不包括恶性黑色素瘤及已发生转移的皮肤癌）；（5）TNM分期为TNM期或更轻分期的前列腺癌；（6）感染艾滋病病毒或患艾滋病期间所患恶性肿瘤。
8.2.2急性心肌梗塞	指因冠状动脉阻塞导致的相应区域供血不足造成部分心肌坏死。须满足下列至少三项条件：（1）典型临床表现，例如急性胸痛等；（2）新近的心电图改变提示急性心肌梗塞；（3）心肌酶或肌钙蛋白有诊断意义的升高，或呈符合急性心肌梗塞的动态性变化；（4）发病90日后，经检查证实左心室功能降低，如左心室射血分数低于50。
8.2.3脑中风后遗症	指因脑血管的突发病变引起脑血管出血、栓塞或梗塞，并导致神经系统永久性的功能障碍。神经系统永久性的功能障碍，指疾病确诊180日后，仍遗留下列一种或一种以上障碍：（1）一肢或一肢以上肢体机能完全丧失；（2）语言能力或咀嚼吞咽能力完全丧失；（3）自主生活能力完全丧失，无法独立完成六项基本日常生活活动中的三项或三项以上。
8.2.4重大器官移植术或造血干细胞移植术	重大器官移植术，指因相应器官功能衰竭，已经实施了肾脏、肝脏、心脏或肺脏的异体移植手术。造血干细胞移植术，指因造血功能损害或造血系统恶性肿瘤，已经实施了造血干细胞（包括骨髓造血干细胞、外周血造血干细胞和脐血造血干细胞）的异体移植手术。
8.2.5冠状动脉搭桥术（或称冠状动脉旁路移植术）	指为治疗严重的冠心病，实际实施了开胸进行的冠状动脉血管旁路移植的手术。冠状动脉支架植入术、心导管球囊扩张术、激光射频技术及其它非开胸的介入手术、腔镜手术不在本保障范围内。
8.2.6终末期肾病（或称慢性肾功能衰竭尿毒症期）	指双肾功能慢性不可逆性衰竭，达到尿毒症期，经诊断后已经进行了至少90日的规律性透析治疗或实施了肾脏移植手术。
8.2.7多个肢体缺失	指因疾病或意外伤害导致二个或二个以上肢体自腕关节或踝关节近端（靠近躯干端）以上完全性断离。
8.2.8急性或亚急性重症肝炎	指因肝炎病毒感染引起肝脏组织弥漫性坏死，导致急性肝功能衰竭，且经血清学或病毒学检查证实，并须满足以下所有条件：（1）重度黄疸或黄疸迅速加重；（2）肝性脑病；（3）B超或其它影像学检查显示肝脏体积急速萎缩；（4）肝功能指标进行性恶化。
8.2.9良性脑肿瘤	指脑的良性肿瘤，已经引起颅内压增高，临床表现为视神经乳头水肿、精神症状、癫痫及运动感觉障碍等，并危及生命。须由头颅断层扫描（CT）、核磁共振检查（MRI）或正电子发射断层扫描（PET）等影像学检查证实，并须满足下列至少一项条件：（1）实际实施了开颅进行的脑肿瘤完全切除或部分切除的手术；（2）实际实施了对脑肿瘤进行的放射治疗。脑垂体瘤、脑囊肿、脑血管性疾病不在本保障范围内。
8.2.10慢性肝功能衰竭失代偿期	指因慢性肝脏疾病导致肝功能衰竭，须满足以下所有条件：（1）持续性黄疸；（2）腹水；（3）肝性脑病；（4）充血性脾肿大伴脾功能亢进或食管胃底静脉曲张。因酗酒或药物滥用导致的肝功能衰竭不在本保障范围内。
8.2.11脑炎后遗症或脑膜炎后遗症	指因患脑炎或脑膜炎导致的神经系统永久性的功能障碍。神经系统永久性的功能障碍，指疾病确诊180日后，仍遗留下列一种或一种以上障碍：（1）一肢或一肢以上肢体机能完全丧失；（2）语言能力或咀嚼吞咽能力完全丧失；（3）自主生活能力完全丧失，无法独立完成六项基本日常生活活动中的三项或三项以上。
8.2.12深度昏迷	指因疾病或意外伤害导致意识丧失，对外界刺激和体内需求均无反应，昏迷程度按照格拉斯哥昏迷分级(Glasgowcomascale)结果为5分或5分以下，且已经持续使用呼吸机及其它生命维持系统96小时以上。因酗酒或药物滥用导致的深度昏迷不在本保障范围内。
8.2.13双耳失聪	指因疾病或意外伤害导致双耳听力永久不可逆性丧失，在500赫兹、1000赫兹和2000赫兹语音频率下，平均听阈大于90分贝，且经纯音听力测试、声导抗检测或听觉诱发电位检测等证实。本合同仅对3周岁以上的被保险人予以理赔。先天性疾病所致的听力丧失不在本保障范围内。
8.2.14双目失明	指因疾病或意外伤害导致双眼视力永久不可逆性丧失，双眼中较好眼须满足下列至少一项条件：（1）眼球缺失或摘除；（2）矫正视力低于0.02（采用国际标准视力表，如果使用其它视力表应进行换算）；（3）视野半径小于5度。本合同仅对3周岁以上的被保险人予以理赔。先天性疾病所致的视力丧失不在本保障范围内。
8.2.15瘫痪	指因疾病或意外伤害导致两肢或两肢以上肢体机能永久完全丧失。肢体机能永久完全丧失，指疾病确诊180日后或意外伤害发生180日后，每肢三大关节中的两大关节仍然完全僵硬，或不能随意识活动。
8.2.16心脏瓣膜手术	指为治疗心脏瓣膜疾病，实际实施了开胸进行的心脏瓣膜置换或修复的手术。
8.2.17严重阿尔茨海默病	指因大脑进行性、不可逆性改变导致智能严重衰退或丧失，临床表现为明显的认知能力障碍、行为异常和社交能力减退，其日常生活必须持续受到他人监护。须由头颅断层扫描（CT）、核磁共振检查（MRI）或正电子发射断层扫描（PET）等影像学检查证实，且自主生活能力完全丧失，无法独立完成六项基本日常生活活动中的三项或三项以上。神经官能症和精神疾病不在本保障范围内。
8.2.18严重脑损伤	指因头部遭受机械性外力，引起脑重要部位损伤，导致神经系统永久性的功能障碍。须由头颅断层扫描（CT）、核磁共振检查（MRI）或正电子发射断层扫描（PET）等影像学检查证实。神经系统永久性的功能障碍，指脑损伤180日后，仍遗留下列一种或一种以上障碍：（1）一肢或一肢以上肢体机能完全丧失；（2）语言能力或咀嚼吞咽能力完全丧失；（3）自主生活能力完全丧失，无法独立完成六项基本日常生活活动中的三项或三项以上。
8.2.19严重帕金森病	是一种中枢神经系统的退行性疾病，临床表现为震颤麻痹、共济失调等。须满足以下所有条件：（1）药物治疗无法控制病情；（2）自主生活能力完全丧失，无法独立完成六项基本日常生活活动中的三项或三项以上。继发性帕金森综合症不在本保障范围内。
8.2.20严重度烧伤	指烧伤程度为度，且度烧伤面积达到全身体表面积的20或20以上。体表面积根据中国新九分法计算。
8.2.21严重原发性肺动脉高压	指不明原因的肺动脉压力持续性增高，进行性发展而导致的慢性疾病，已经造成永久不可逆性的体力活动能力受限，达到美国纽约心脏病学会心功能状态分级IV级，且静息状态下肺动脉平均压超过30mmHg。
8.2.22严重运动神经元病	是一组中枢神经系统运动神经元的进行性变性疾病，包括进行性脊肌萎缩症、进行性延髓麻痹症、原发性侧索硬化症、肌萎缩性侧索硬化症。须满足自主生活能力完全丧失，无法独立完成六项基本日常生活活动中的三项或三项以上的条件。
8.2.23语言能力丧失	指因疾病或意外伤害导致完全丧失语言能力，经过积极治疗至少12个月（声带完全切除不受此时间限制），仍无法通过现有医疗手段恢复。精神心理因素所致的语言能力丧失不在本保障范围内。本合同仅对3周岁以上的被保险人予以理赔。先天性失聪导致的语言能力丧失不在本保障范围内。
8.2.24重型再生障碍性贫血	指因骨髓造血功能慢性持续性衰竭导致的贫血、中性粒细胞减少及血小板减少。须满足以下所有条件：（1）骨髓穿刺检查或骨髓活检结果支持诊断；（2）外周血象须具备以下三项条件：中性粒细胞绝对值0.510；网织红细胞1；血小板绝对值2010/L。
8.2.25主动脉手术	指为治疗主动脉疾病，实际实施了开胸或开腹进行的切除、置换、修补病损主动脉血管的手术。主动脉指胸主动脉和腹主动脉，不包括胸主动脉和腹主动脉的分支血管。动脉内血管成形术不在本保障范围内。
8.2.26严重心肌病	指被保险人因心肌病导致慢性心功能损害造成永久不可逆性的心功能衰竭。心功能衰竭程度达到纽约心脏病学会的心功能分级标准之心功能IV级。被保险人永久不可逆性的体力活动能力受限，不能从事任何体力活动。
8.2.27慢性呼吸功能衰竭	慢性肺部疾病导致永久不可逆性的慢性呼吸功能衰竭。慢性呼吸功能衰竭必须明确诊断且满足以下所有条件：（1）休息时出现呼吸困难；（2）动脉血氧分压（PaO2）50mmHg；（3）动脉血氧饱和度（SaO2）80；（4）因缺氧必须接受持续的输氧治疗。发性硬化必须明确诊断，并且已经造成永久不可逆的神经系统功能损害。永久不可逆的神经系统损害指被保险人持续180天无法独立完成下列基本日常生活活动之一：（1）移动：自己从一个房间到另一个房间；（2）进食：自己从已准备好的碗或碟中取食物放入口中。
8.2.29职业原因致人类免疫缺陷病毒（HIV）感染	被保险人的职业归属于下列职业列表内的职业，在其常规职业工作过程中遭遇外伤，或者职业需要处理血液或者其他体液时感染上人类免疫缺陷病毒（HIV）。必须满足以下所有条件：（1）感染必须是在被保险人正在从事其职业工作中发生；（2）血清转化必须出现在事故发生后的6个月以内；（3）必须提供被保险人在所报事故发生后的5天以内进行的检查报告，该报告必须显示被保险人血液HIV病毒阴性和/或HIV抗体阴性；（4）必须在事故发生后的12个月内证实被保险人体内存在HIV病毒或者HIV抗体。在任何治愈艾滋病（AIDS）或阻止HIV病毒作用的疗法被发现以后，或能防止AIDS发生的医疗方法被研究出来以后，本保障将不再予以赔付。任何因其他传播方式（包括：输血、性传播或静脉注射毒品）导致的HIV感染不在本保障范围内。百年人寿必须拥有获得使用被保险人的所有血液样本的权利和能够对这些样本进行独立检验的权利。
8.2.30严重溃疡性结肠炎	本合同所保障的溃疡性结肠炎是指伴有致命性电解质紊乱的急性暴发性溃疡性结肠炎，病变累及全结肠，表现为严重的血便和系统性症状体征，治疗通常采取全结肠切除和回肠造瘘术。溃疡性结肠炎必须根据组织病理学特点诊断，并且被保险人已经接受了结肠切除和回肠造瘘术。
8.2.31严重全身性重症肌无力	重症肌无力是一种神经肌肉接头传递障碍所致的疾病，表现为局部或全身骨骼肌（特别是眼外肌）极易疲劳。疾病可以累及呼吸肌、上肢或下肢的近端肌群或全身肌肉，必须满足下列所有条件：（1）经药物治疗和胸腺切除治疗一年以上仍无法控制病情；（2）自主生活能力完全丧失，无法独立完成六项基本日常生活活动中的三项或三项以上。
8.2.32严重类风湿性关节炎	类风湿性关节炎为广泛分布的慢性进行性多关节病变，表现为关节严重变形，侵犯至少三个主要关节或关节组如：双手（多手指）关节、双足（多足趾）关节、双腕关节、双膝关节和双髋关节。类风湿性关节炎必须明确诊断并且已经达到类风湿性关节炎功能分类IV级的永久不可逆性关节功能障碍（生活不能自理，且丧失活动能力）。美国风湿病学会类风湿性关节炎分级：I级：关节能自由活动，能完成平常的任务而无妨碍。II级：关节活动中度限制，一个或几个关节疼痛不适，但能料理日常生活。级：关节活动显著限制，不能胜任工作，料理生活也有困难。IV级：大部分或完全失去活动能力，病人长期卧床或依赖轮椅，生活不能自理。
8.2.33脊髓灰质炎后遗症	脊髓灰质炎是由于脊髓灰质炎病毒感染所致的瘫痪性疾病，临床表现为运动功能损害或呼吸无力。脊髓灰质炎必须明确诊断。本合同仅对脊髓灰质炎造成的神经系统功能损害导致被保险人一肢或一肢以上肢体机能永久完全丧失的情况予以理赔。肢体机能永久完全丧失，指疾病确诊180天后，每肢三大关节中的两大关节仍然完全僵硬，或不能随意识活动。
8.2.34输血原因致人类免疫缺陷病毒（HIV）感染	被保险人因输血感染上人类免疫缺陷病毒（HIV）并且满足以下所有条件：（1）在保障起始日或复效日之后，被保险人因输血而感染HIV；（2）提供输血治疗的输血中心或医院出具该项输血感染属医疗责任事故的报告，或者法院终审裁定为医疗责任；（3）受感染的被保险人不是血友病患者。在任何治愈艾滋病（AIDS）或阻止HIV病毒作用的疗法被发现以后，或能防止AIDS发生的医疗方法被研究出来以后，本保障将不再予以赔付。任何因其他传播方式（包括：性传播或静脉注射毒品）导致的HIV感染不在本保障范围内。百年人寿必须拥有获得使用被保险人的所有血液样本的权利和能够对这些样本进行独立检验的权利。
8.2.35严重克隆病	克隆病是一种慢性肉芽肿性肠炎，具有特征性的克隆病病理组织学变化。诊断必须由病理检查结果证实。被保险人所患的克隆病必须已经造成瘘管形成并伴有肠梗阻或肠穿孔。
8.2.36肌营养不良症	肌营养不良症是一组遗传性肌肉变性性病变，临床特征为与神经系统无关的肌肉无力和肌肉萎缩。须满足自主生活能力完全丧失，无法独立完成六项基本日常生活活动中的三项或三项以上。
8.2.37破裂脑动脉瘤开颅夹闭手术	指因脑动脉瘤破裂造成蛛网膜下腔出血，被保险人实际接受了在全麻下进行的开颅脑动脉瘤夹闭手术。脑动脉瘤（未破裂）预防性手术、颅骨打孔手术、动脉瘤栓塞手术、血管内手术及其他颅脑手术不在本保障范围内。
性硬皮病	诊断必须明确并由活检和血清学证据支持并且疾病已经影响到心脏、肺或肾脏等内脏器官并且达到下列标准之一。（1）肺纤维化，已经出现肺动脉高压、肺心病；（2）心脏损害，心脏功能衰竭程度达到纽约心脏病学会的心功能分级标准之心功能IV级；（3）肾脏损害，已经出现肾功能衰竭。下列疾病不在本保障范围内：（1）局限硬皮病；（2）嗜酸细胞筋膜炎；（3）CREST综合征。
8.2.39严重冠心病	指被保险人经由冠状动脉造影检查明确诊断为三支主要血管严重狭窄性病变（至少一支血管管腔直径减少75以上和其他两支血管管腔直径减少60以上）。冠状动脉主要血管指左冠状动脉主干、前降支、左旋支及右冠状动脉。前降支、左旋支及右冠状动脉的分支血管的狭窄不作为本保障的衡量指标。
8.2.40严重慢性复发性胰腺炎	指慢性反复发作的胰腺炎症导致胰腺的广泛纤维化、坏死、弥漫性钙化及假性囊肿形成，造成胰腺功能障碍出现严重糖尿病和营养不良。必须满足下列所有条件：（1）医疗记录证实存在慢性胰腺炎反复急性发作病史；（2）CT显示胰腺广泛钙化或逆行胰胆管造影（ERCP）显示胰管扭曲、扩张和狭窄；（3）持续接受胰岛素替代治疗和酶替代治疗180天以上。酒精导致的慢性复发性胰腺炎不在本保障范围内。
8.2.41植物人状态	植物人状态系指由于严重颅脑外伤造成大脑和/或脑干严重损害导致完全永久性的对自身和环境的意识丧失和中枢神经系统功能丧失，仅残存植物神经功能的疾病状态。诊断必须明确并且具有严重颅脑外伤和脑损害的证据。植物人状态必须持续30天以上方可申请理赔。
8.2.42重症急性坏死性筋膜炎截肢	是一种由细菌侵入皮下组织和筋膜引起的急性坏死性软组织感染，可伴有毒血症、败血症、中毒性休克、弥漫性血管内凝血及多器官衰竭。必须满足下列所有条件：（1）细菌培养和临床表现符合坏死性筋膜炎诊断标准；（2）病情迅速恶化，有脓毒血症表现；（3）受感染肢体被截肢（自腕关节或踝关节近端）。
8.2.43嗜铬细胞瘤	指发生在肾上腺或肾上腺外嗜铬组织的以分泌过多的儿茶酚胺为表现的神经内分泌肿瘤。嗜铬细胞瘤必须明确诊断，并且满足下列所有条件：（1）临床有高血压症候群表现；（2）已经实施了嗜铬细胞瘤切除手术。
8.2.44丝虫感染所致严重象皮病	指因丝虫感染导致淋巴循环阻塞出现严重淋巴水肿，达到国际淋巴学会淋巴肿分期第期，临床表现为肢体象皮肿，患肢较健肢增粗30以上，日常生活不能自理。
8.2.45胰腺移植术	胰腺移植术指因胰腺功能衰竭，已经实际接受了在全麻下进行的胰腺的同种（人类）异体器官移植手术。胰岛、组织、细胞移植不在本保障范围内。
8.2.46特发性慢性肾上腺皮质功能减退	指自身免疫性肾上腺炎（既往称：特发性肾上腺皮质萎缩）导致肾上腺萎缩和慢性肾上腺皮质功能减退。必须满足下列所有条件：（1）明确诊断，符合下列所有诊断标准：血浆促肾上腺皮质激素（ACTH）水平100pg/ml；血浆肾素活性、血管紧张素II和醛固酮测定结果显示为原发性肾上腺皮质功能减退症；促肾上腺皮质激素（ACTH）刺激试验显示为原发性肾上腺皮质功能减退症。（2）已经采用皮质类固醇替代治疗180天以上。肾上腺结核、HIV感染或艾滋病、感染、肿瘤所致的原发性肾上腺皮质功能减退和继发性肾上腺皮质功能减退不在本保障范围内。
8.2.47严重心肌炎	指被保险人因严重心肌炎症性病变导致心功能损害造成持续的永久不可逆性的心功能衰竭。必须满足下列所有条件：（1）心功能衰竭程度达到纽约心脏病学会的心功能分级标准之心功能IV级，或左室射血分数低于30；（2）持续不间断180天以上。被保险人永久不可逆性的体力活动能力受限，不能从事任何体力活动。
病	造成永久不可逆性的心功能衰竭。心功能衰竭程度达到纽约心脏病学会的心功能分级标准之心功能IV级。被保险人永久不可逆性的体力活动能力受限，不能从事任何体力活动。
8.2.49严重原发性硬化性胆管炎	为一种特发型淤胆性疾病，特点为肝内及肝外胆道系统胆管壁增厚和管腔狭窄。必须满足下列所有条件：（1）诊断由逆行胰胆管造影（ERCP）或经皮胆管造影（PTC）确认；（2）持续性黄疸伴碱性磷酸酶（ALP）显著升高；（3）出现继发性胆汁性肝硬化和门静脉高压。
8.2.50严重慢性自身免疫性肝炎	自身免疫性肝炎是一种原因不明的慢性肝脏的坏死性炎性疾病，机体免疫机制被破坏，产生针对肝脏自身抗原的抗体导致自身免疫反应，从而破坏肝细胞造成肝脏炎症坏死，进而发展为肝硬化。必须满足所有以下条件：（1）高球蛋白血症；（2）血液中存在高水平的自身免疫抗体，如ANA（抗核抗体）、SMA（抗平滑肌抗体）、抗LKM1抗体或抗SLA/LP抗体；（3）肝脏活检证实免疫性肝炎；（4）临床已经出现腹水、食道静脉曲张和脾肿大等肝硬化表现。
8.2.51原发性骨髓纤维化	原发性骨髓纤维化以骨髓纤维增生和髓外造血为特点，表现为进行性贫血、脾肿大、外周血幼稚细胞等。被保险人须经由骨髓活检明确诊断为原发性骨髓纤维化，并满足下列所有条件且持续180天：（1）血红蛋白100g/L；（2）白细胞计数25109/L；（3）外周血原始细胞1；（4）血小板计数100109/L。恶性肿瘤、中毒、放射线和感染所致的继发性骨髓纤维化不在本保障范围内。
8.2.52严重骨髓增生异常综合征	骨髓增生异常综合征是起源于造血干细胞的一组骨髓克隆异常的疾病，表现为无效造血、难治性血细胞减少，有转化为急性髓系白血病的风险。被保险人须经由外周血和骨髓活检明确诊断为骨髓增生异常综合征，并且满足下列所有条件：（1）根据WHO分型，分型为难治性贫血伴原始细胞增多（RAEB）；（2）根据骨髓增生异常综合征修订国际预后积分系统（IPSSR）积分3，属于中危及以上组。
8.2.53自体造血干细胞移植	被保险人因急性白血病、恶性淋巴瘤或多发性骨髓瘤实际接受了自体造血干细胞移植。以下情况不在本保障范围内：（1）因上述所列疾病以外疾病接受自体造血干细胞移植；（2）非造血干细胞移植。
8.2.54严重感染性心内膜炎	感染性心内膜炎是指因细菌或其他致病菌感染造成心脏内膜感染，瓣膜为最常受累部位，引起心脏瓣膜关闭不全。必须满足下列至少三项条件：（1）急性或亚急性感染性心内膜炎临床表现；（2）血培养病原体阳性；（3）心功能衰竭并实际接受了心脏瓣膜置换手术；（4）并发动脉栓塞导致脑梗塞、肾梗塞或心肌梗塞。药物滥用者所患感染性心内膜炎不在本保障范围内。
8.2.55严重急性主动脉夹层血肿	指主动脉壁在受到某些病理因素破坏后，高速、高压的主动脉血流将其内膜撕裂，以致主动脉腔内的血流通过主动脉内膜的破裂口进入主动脉内壁而形成血肿。急性主动脉夹层血肿必须明确诊断，并且满足下列所有条件：（1）有典型的临床表现；（2）有电子计算机断层扫描（CT）、磁共振扫描（MRI）、磁共振血管造影（MRA）等影像学证据支持诊断；（3）被保险人实际接受了急诊条件下进行的传统或微创开胸或开腹主动脉手术。慢性期主动脉夹层择期手术、经导管主动脉内介入手术治疗不在本保障范围内。
8.2.56严重慢性缩窄性心包炎	由于慢性心包炎症导致心包脏层和壁层广泛瘢痕粘连、增厚和钙化，心包腔闭塞，形成一个纤维瘢痕外壳，使心脏和大血管根部受压，阻碍心脏的舒张。慢性缩窄性心包炎必须被明确诊断并且满足下列所有条件：（1）心功能衰竭达到美国纽约心脏病学会心功能状态分级IV级，并持续180天以上；（2）已经接受了经下列任何一种手术路径进行的开胸心包剥离手术或心包切除手术：胸骨正中切口；双侧前胸切口；左前胸肋间切口。经胸腔镜、胸壁打孔进行的手术、心包粘连松解手术不在本保障范围内。
8.2.57心脏粘液瘤	指为了治疗心脏粘液瘤，实际实施了开胸开心心脏粘液瘤切除手术。经导管介入手术治疗不在本保障范围内。
8.2.58严重心脏衰竭CRT心脏再同步治疗	指因缺血性心脏病或扩张性心肌病导致慢性严重心脏衰竭，被保险人实际接受了CRT治疗，以矫正心室收缩不协调和改善心脏功能。接受治疗之前必须满足下列所有条件：（1）心功能衰竭程度达到纽约心脏病学会的心功能分级标准之心功能级或IV级；（2）左室射血分数低于35；（3）左室舒张末期内径55mm；（4）QRS时间130msec；（5）药物治疗效果不佳，仍有症状。
8.2.59完全性房室传导阻滞	指因慢性心脏疾病导致完全性房室传导阻滞。完全性房室传导阻滞是心房的激动不能正常地传导到心室，造成心室率过于缓慢，出现心力衰竭和因大脑供血不足导致的晕厥、阿斯综合征。必须明确诊断并且满足下列所有条件：（1）患有慢性心脏疾病；（2）曾经有晕厥、阿斯综合征发作；（3）心电图表现为持续室性逸搏心律，心室率持续低于40次/分；（4）已经植入永久性心脏起搏器。
8.2.60风湿热导致的心脏瓣膜病	指风湿热反复发作并发心脏瓣膜损害，导致慢性心脏瓣膜病，引起心脏瓣膜狭窄、关闭不全。必须满足下列所有条件：（1）风湿热病史；（2）慢性心脏瓣膜病病史；（3）实际接受了开胸开心进行的心脏瓣膜置换手术。经导管进行的瓣膜置换手术或瓣膜成型手术不在本保障范围内。
8.2.61头臂动脉型多发性大动脉炎旁路移植手术	多发性大动脉炎（高安氏动脉炎）是一种发生在主动脉和其主要分支的慢性炎症性动脉疾病，表现为受累动脉狭窄或闭塞。头臂动脉型多发性大动脉炎是指多发性大动脉炎头臂动脉型（I型），又称为无脉症。被保险人被明确诊断为头臂动脉型多发性大动脉炎并且实际接受了经胸部切开进行的无名动脉（头臂干）、颈总动脉、锁骨下动脉旁路移植手术。非开胸的血管旁路移植手术、因其他病因而进行的旁路移植手术，对其他动脉进行的旁路移植手术，经皮经导管进行的血管内手术不在本保障范围内。
8.2.62肺淋巴管肌瘤	肺淋巴管肌瘤病是一种弥漫性肺部疾病，其特征性病理表现为囊性病变及不成熟的平滑肌细胞和血管周围上皮细胞异常增生形成多发结节。必须满足下列所有条件：（1）经组织病理学检查明确诊断；（2）CT显示双肺弥漫性囊性改变；（3）肺功能检查显示FEV1和DLCO（CO弥散功能）下降；（4）动脉血气分析显示低氧血症。疑似肺淋巴管肌瘤病除外。
8.2.63严重肺结节病	结节病是一种原因未明的慢性肉芽肿病，可侵犯全身多个器官，以肺和淋巴结受累最为常见。严重肺结节病表现为肺的广泛纤维化导致慢性呼吸功能衰竭。必须满足下列所有条件：（1）肺结节病的X线分期为IV期，即广泛肺纤维化；（2）永久不可逆性的慢性呼吸功能衰竭，临床持续180天动脉血氧分压（PaO2）50mmHg和动脉血氧饱和度（SaO2）80。
8.2.64非阿尔茨海默病至严重痴呆	指因阿尔茨海默病以外的脑的器质性疾病造成脑功能衰竭导致永久不可逆性的严重痴呆，临床表现为明显的认知能力障碍、行为异常和社交能力减退。被保险人自主生活能力完全丧失，无法独立完成六项基本日常生活活动中的三项或三项以上，日常生活必须持续受到他人监护。导致痴呆的疾病必须明确诊断，且由完整的临床、实验室和影像学检查结果证实。神经官能症，精神疾病及酒精中毒所致脑损害不在本保障范围内。
8.2.65进行性核上性麻痹	进行性核上性麻痹是中枢神经系统变性性疾病，临床表现为眼球运动障碍、假性球麻痹、帕金森综合征等。被保险人自主生活能力完全丧失，无法独立完成六项基本日常生活活动中的三项或三项以上，日常生活必须持续受到他人监护。
雅氏病	
8.2.66克（CJD、人类疯牛病）	CJD是一种传染性海绵状脑病，临床表现为快速进行性痴呆、肌阵挛和特征性脑电图变化。本病须经三级医院的专科医师根据WHO诊断标准明确诊断，并且被保险人永久不可逆丧失自主生活能力，无法独立完成六项基本日常生活活动中的三项或三项以上。
8.2.67亚急性硬化性全脑炎	是麻疹或麻疹样病毒所致的一种中枢神经系统慢病毒感染。中枢神经系统呈现灰质和白质破坏为特征的慢性和急性混合存在的炎症。必须满足下列所有条件：（1）必须由三级医院诊断，临床检查证实脑电图存在周期性复合波、脑脊液球蛋白升高、脑脊液和血清中麻疹抗体滴定度升高；（2）被保险人出现运动障碍，永久不可逆丧失自主生活能力，无法独立完成六项基本日常生活活动中的三项或三项以上。
8.2.68进行性多灶性白质脑病	是一种亚急性脱髓鞘脑病，常常发生于免疫缺陷病人。必须满足下列所有条件：（1）根据脑组织活检确诊；（2）永久不可逆丧失自主生活能力，无法独立完成六项基本日常生活活动中的三项或三项以上。
8.2.69丧失独立生活能力	指由于疾病或外伤导致被保险人永久不可逆的完全丧失独立生活能力，无法独立完成基本日常生活活动中的四项或四项以上。被保险人理赔时年龄在6周岁以上。关的疾病。必须满足下列所有条件：（1）脊髓小脑变性症必须由三级医院诊断，并有下列所有证据支持：影像学检查证实存在小脑萎缩；临床表现存在共济失调、语言障碍和肌张力异常；（2）被保险人运动功能严重障碍，自主生活能力完全丧失，无法独立完成六项基本日常生活活动中的三项或三项以上。
8.2.71神经白塞病	白塞病是一种慢性全身性血管炎症性疾病，主要表现为复发性口腔溃疡、生殖器溃疡、眼炎及皮肤损害，并可累及大血管、神经系统、消化道、肺、肾等。累及神经系统损害的白塞病称为神经白塞病。神经白塞病必须明确诊断，并且已经造成永久不可逆的神经系统功能损害。永久不可逆的神经系统损害指被保险人持续180天无法独立完成下列基本日常生活活动之一：（1）移动：自己从一个房间到另一个房间；（2）进食：自己从已准备好的碗或碟中取食物放入口中。
8.2.72脊髓内肿瘤	指脊髓内良性或恶性肿瘤。肿瘤造成脊髓损害导致瘫痪。须满足下列所有条件：（1）被保险人实际接受了肿瘤切除的手术治疗；（2）手术180天后遗留下列神经系统损害，无法独立完成下列基本日常生活活动之一：移动：自己从一个房间到另一个房间；进食：自己从已准备好的碗或碟中取食物放入口中。非脊髓内的其他椎管内肿瘤、脊柱肿瘤、神经纤维瘤不在本保障范围内。
8.2.73横贯性脊髓炎后遗症	脊髓炎是一种炎症性脊髓疾病。横贯性脊髓炎是指炎症扩展横贯整个脊髓，表现为运动障碍、感觉障碍和自主神经功能障碍。横断性脊髓炎必须明确诊断，并且已经造成永久不可逆的神经系统功能损害。永久不可逆的神经系统损害指被保险人持续180天无法独立完成下列任何一项基本日常生活活动：（1）移动：自己从一个房间到另一个房间；（2）进食：自己从已准备好的碗或碟中取食物放入口中。
8.2.74脊髓空洞症	脊髓空洞症为慢性进行性的脊髓变性性疾病，其特征为脊髓内空洞形成。表现为感觉异常、肌萎缩及神经营养障碍。脊髓空洞症累及延髓称为延髓空洞症，表现为延髓麻痹。脊髓空洞症必须明确诊断并且造成永久不可逆的神经系统功能障碍，存在持续至少180天以上的神经系统功能缺失并满足下列任一条件：（1）延髓麻痹呈现显著舌肌萎缩、构音困难和吞咽困难；（2）双手萎缩呈爪形手，肌力2级或以下。
8.2.75脊髓血管病后遗症	指脊髓血管的突发病变引起脊髓梗塞或脊髓出血，导致永久性不可逆的神经系统功能损害，表现为截瘫或四肢瘫。神经系统永久性的功能障碍指疾病确诊180天后，仍然遗留后遗症并且无法独立完成下列基本日常生活活动之一：（1）移动：自己从一个房间到另一个房间；（2）进食：自己从已准备好的碗或碟中取食物放入口中。
8.2.76开颅手术	指因外伤、颅内肿瘤或脑动脉瘤破裂，被保险人实际接受了在全麻下进行的颅骨切开手术，以清除脑内血肿、切除肿瘤或夹闭破裂动脉瘤的手术治疗。颅骨打孔手术、硬膜下血肿清除术、未破裂动脉瘤预防性手术、动脉瘤栓塞手术、血管内手术、颅骨切开或切除减压术、脑积水脑脊液分流手术、经蝶骨肿瘤切除术及其他原因的开颅手术不在本保障范围内。
8.2.77系统性红斑狼疮性肾炎尿毒症	系统性红斑狼疮是由多种因素引起，累及多系统的自身免疫性疾病。其特点是生成自身抗体对抗多种自身抗原。多见于育龄妇女。本合同所指的系统性红斑狼疮仅限于累及肾脏（经肾脏活检确认的，符合WHO诊断标准定义型或型以上狼疮性肾炎）的系统性红斑狼疮，并且临床出现肾功能衰竭达到尿毒症期。其他类型的红斑性狼疮，如盘状狼疮、仅累及血液及关节的狼疮不在本保障范围取
8.2.781型糖尿病严重并发症	1型糖尿病的特征为由于胰岛素分泌绝对不足引起严重胰岛素缺乏导致慢性血糖升高，需要依赖外源性胰岛素进行机体的葡萄糖代谢和维持生命。被保险人的1型糖尿病必须明确诊断，而且有血胰岛素测定及血C肽或尿C肽测定结果支持诊断，并且满足下列所有条件：（1）已经持续性地接受外源性胰岛素注射治疗连续180天以上；（2）因需要已经接受了下列治疗之一：因严重心律失常植入了心脏起搏器；因坏疽自跖趾关节或以上切除了一趾或多趾。
8.2.79席汉氏综合征	指因产后大出血并发休克、全身循环衰竭、弥漫性血管内凝血导致脑垂体缺血坏死和垂体分泌激素不足，造成性腺、甲状腺、肾上腺皮质功能减退。必须满足下列所有条件：（1）产后大出血休克病史；（2）严重腺垂体功能破坏，破坏程度95；（3）影像学检查显示脑垂体严重萎缩或消失；（4）实验室检查显示：垂体前叶激素全面低下（包括生长激素、促甲状腺素、促肾上腺皮质激素、卵泡刺激素和黄体生成素）；性激素、甲状腺素、肾上腺皮质激素全面低下。（5）需要终身激素替代治疗以维持身体功能，持续服用各种替代激素超过一年。垂体功能部分低下及其他原因所致垂体功能低下不在本保障范围之内。
8.2.80严重强直性脊柱炎	强直性脊柱炎是一种慢性全身性炎性疾病，主要侵犯脊柱导致脊柱畸形。强直性脊柱炎必须明确诊断并且满足下列所有条件：（1）严重脊柱畸形；（2）自主生活能力完全丧失，无法独立完成六项基本日常生活活动中的三项或三项以上。
8.2.81肾髓质囊性病	肾髓质囊性病，一种遗传性肾脏疾病，特点为肾髓质多发大小不等的囊肿并且伴有小管炎症和间质性肾炎。必须满足下列所有条件：（1）经肾组织活检明确诊断；（2）临床有肾脏衰竭和肾小管功能障碍表现；（3）影像学证据显示肾髓质多发囊肿。其他肾脏囊性病变不在本保障范围内。
8.2.82肝豆状核变性	肝豆状核变性是一种遗传性铜代谢障碍疾病。表现为体内的铜离子在肝、脑、肾、角膜等处沉积，引起进行性加重的肝硬化、锥体外系症状、精神症状、肾损害及角膜色素环。肝豆状核变性必须明确诊断并且满足以下条件之一：（1）帕金森综合征或其他神经系统功能损害，自主生活能力完全丧失，无法独立完成六项基本日常生活活动中的三项或三项以上；（2）失代偿性肝硬化，临床已经出现腹水、食道静脉曲张和脾肿大等表现；（3）慢性肾功能衰竭，已开始肾脏透析治疗；（4）接受了肝移植或肾移植手术。
8.2.83重症急性出血坏死性胰腺炎开腹手术	指被保险人被确诊为重症急性出血坏死性胰腺炎，并实际接受了外科剖腹直视手术治疗，进行坏死组织清除、坏死病灶切除或胰腺切除。腹腔镜手术治疗、因酗酒或饮酒过量所致的急性坏死性胰腺炎不在本保障范围内。
8.2.84小肠移植术	小肠移植术指因疾病或外伤导致严重小肠损害不得不切除三分之二以上肠段，为了维持生理功能的需要已经实际接受了小肠的同种（人类）异体器官移植手术。
8.2.85意外导致的重度面部烧伤	指面部度烧伤且烧伤面积达到面部表面积的2/3或全身体表面积的2。体表面积根据中国新九分法计算，面部总面积为全身体表面积的3。面部面积不包括发部和颈部。下列所有条件：（1）一肢体丧失指任何一肢体自腕关节或踝关节近端（靠近躯干端）以上完全性断离。（2）一眼视力丧失指一只眼视力永久不可逆性丧失，患眼须满足下列至少一项条件：眼球摘除；矫正视力低于0.02（采用国际标准视力表，如果使用其它视力表应进行换算）；视野半径小于5度。除眼球摘除以外，被保险人申请理赔时年龄必须在3周岁以上，并且提供理赔当时的视力丧失诊断及检查证据。
8.2.87溶血性链球菌感染引起的坏疽	由于急性溶血性链球菌感染导致广泛的皮肤、皮下组织和深层组织的坏死。必须满足以下所有条件：（1）细菌培养证实致病菌为溶血性链球菌；（2）受感染肢体被截肢（自腕关节或踝关节近端）。
8.2.88器官移植致人类免疫缺陷病毒（HIV）感染	被保险人因接受器官移植感染上人类免疫缺陷病毒（HIV）并且满足以下所有条件：（1）在保障起始日或复效日之后，被保险人接受器官移植，并因此感染HIV；（2）实施器官移植的医院为三级甲等医院；（3）实施移植医院出具具有法律效力的证明确认移植器官来自HIV感染者。在任何治愈艾滋病（AIDS）或阻止HIV病毒作用的疗法被发现以后，或能防止AIDS发生的医疗方法被研究出来以后，本保障将不再予以赔付。的有合法资质的传染病专家确诊并且已上报国家疾病控制中心并接受了隔离和治疗，必须满足以下所有条件：（1）实验室检查证据证实存在埃博拉病毒感染；（2）存在持续30天以上广泛出血的临床表现。埃博拉病毒感染疑似病例，在确诊之前已经死亡的病例不在本保障范围内。足下列所有条件：（1）有晕厥或心脏骤停病史，并提供完整的诊疗记录；（2）心电图有典型的I型Brugada波；（3）已经安装了永久性心脏起搏器。
8.2.91川崎病冠状动脉瘤手术	川崎病为一种病因不明的系统性血管炎。本合同仅对诊断性检查证实川崎病并发冠状动脉瘤或其他心血管异常并且实际接受了手术治疗的情况予以理赔。
8.2.92严重幼年型类风湿关节炎	幼年型类风湿关节炎是一种儿童期发病的慢性关节炎，其特点为在高热和系统性病征出现数月后发生关节炎。本合同仅对实际接受了膝关节或髋关节置换手术治疗的严重的幼年型类风湿关节炎予以理赔。
8.2.93因疾病或外伤导致智力缺陷	因严重头部创伤或疾病造成被保险人智力低常（智力低于常态）或智力残疾。根据智商（IQ）智力低常分为轻度（IQ5070）；中度（IQ3550）；重度（IQ2035）和极重度（IQ20）。智商7085为智力临界低常，不在本保障范围内。智商的检测必须由本公司认可的专职心理测验工作者进行，心理测验工作者必须持有由心理测量专业委员会资格认定书。根据被保险人年龄采用对应的智力量表如韦克斯勒智力量表（儿童智力量表或成人智力量表）。理赔时必须满足以下所有条件：（1）被保险人大于或等于6周岁，且在做智力鉴定并确诊时小于25周岁；（2）主任医师确诊被保险人由于严重头部创伤或疾病造成智力低下；（3）专职合格心理检测工作者适时做的心理检测证实被保险人智力低常（轻度、中度、重度或极重度）；（4）被保险人的智力低常自确认日起持续180天以上。
8.2.94严重肠道疾病并发症	严重肠道疾病或外伤导致小肠损害并发症，必须满足以下所有条件：（1）至少切除了三分之二小肠；（2）完全肠外营养支持3个月以上。引起短链脂肪酸、血氨升高，造成脑水肿。主要临床表现为急性发热、反复呕吐、惊厥及意识障碍等。肝脏活检是确诊的重要手段。瑞氏综合征需由三级医院的专科医生确诊，并满足下列所有条件：（1）有脑水肿和颅内压升高的脑脊液检查和影像学检查证据；（2）血氨超过正常值的3倍；（3）临床出现昏迷，病程至少达到疾病分期第3期。
8.2.96急性肺损伤（ALI）或急性呼吸窘迫综合征（ARDS）	一种表现为无心脏衰竭的肺水肿，为创伤、脓毒血症等临床多种疾病的并发症，造成多器官衰竭，死亡率高。急性肺损伤或急性呼吸窘迫综合征必须由呼吸系统专科医师诊断，被保险人理赔时年龄在25周岁以下，并有所有以下临床证据支持。（1）急性发作（原发疾病起病后6至72小时）；（2）急性发作的临床症状体征，包括呼吸急促、呼吸困难、心动过速、大汗、面色苍白及辅助呼吸肌活动加强（点头呼吸、提肩呼吸）；（3）双肺浸润影；（4）PaO2/FiO2（动脉血压分压/吸入气氧分压）低于200mmHg；（5）肺动脉嵌入压低于18mmHg；（6）临床无左房高压表现。
8.2.97溶血性尿毒综合征	一种由于感染导致的急性综合征，引起红细胞溶血，肾功能衰竭及尿毒症。溶血尿毒综合征必须由血液和肾脏专科医师诊断，被保险人理赔时年龄在25周岁以下，并且满足下列所有条件：（1）实验室检查确认有溶血性贫血、血尿、尿毒症、血小板减少性紫癜；（2）因肾脏功能衰竭实施了肾脏透析治疗。任何非因感染导致的溶血性贫血，如：自身免疫性溶血性贫血、与红细胞膜缺陷有关的溶血性贫血、红细胞酶病、血红蛋白病等，不在本保障范围内。
8.2.98亚历山大病	亚历山大病（AlexandersDisease）是一种遗传性中枢神经系统退行性病变，特点为脑白质营养不良性。临床表现为惊厥发作、智力下降、球麻痹、共济失调、痉性瘫痪。亚历山大病必须被明确诊断，并且造成永久性神经系统功能障碍。被保险人自主生活能力完全丧失，无法独立完成六项基本日常生活活动中的三项或三项以上，日常生活必须持续接受他人护理。未明确诊断的疑似病例不在本保障范围之内。
8.2.99多发性骨髓瘤	多发性骨髓瘤是浆细胞异常增生的恶性肿瘤。必须满足下列所有条件：（1）骨髓活组织检查符合多发性骨髓瘤的典型骨髓改变；（2）至少存在下列一项：异常球蛋白血症；溶骨性损害。切除手术治疗。经导管心室内成型手术治疗不在本保障范围内。
中症疾病	
9.1中症疾病	本合同所指中症疾病，是被保险人经百年人寿认可的医院专科医生明确诊断，发生符合以下定义所述条件的疾病、疾病状态或手术，共计20种。中症疾病名称及定义如下：
9.1.1中度类风湿性关节炎	类风湿性关节炎为广泛分布的慢性进行性多关节病变，表现为关节严重变形，侵犯两个主要关节或关节组（如：双手（多手指）关节、双足（多足趾）关节、双腕关节、双膝关节和双髋关节）。且被保险人满足至少180天无法独立完成六项基本日常生活活动。
9.1.2中度脑中风后遗症	指因脑血管的突发病变引起脑血管出血、栓塞或者梗塞，并导致神经系统出现功能障碍表现，在确诊180天后神经系统功能障碍程度虽未达到重大疾病脑中风后遗症的给付标准，但仍遗留下列一种或者一种以上障碍：（1）一肢或一肢以上肢体肌力级或级以下的运动功能障碍；（2）自主生活能力完全丧失，无法独立完成六项基本日常生活活动中的两项或者两项以上。短暂性脑缺血发作(TIA)和腔隙性脑梗塞不在本保障范围内。
9.1.3中度脑损伤	指因头部遭受机械性外力，引起脑重要部位损伤，导致神经系统永久性的功能障碍。须由头颅断层扫描（CT）、核磁共振检查（MRI）或正电子发射断层扫描（PET）等影像学检查证实。神经系统永久性的功能障碍，指脑损伤180天后，仍部分丧失自主生活能力，无法独立完成六项基本日常生活活动中的二项或以上。
9.1.4中度面积度烧伤	指烧伤程度为度，即全层皮肤烧伤，包括表皮、真皮和皮下组织，且度烧伤的面积达到全身体表面积的15或15以上。因同一次意外事故原因所致的中度面积度烧伤、意外导致的中度面部烧伤，百年人寿仅赔付其中一项中症疾病保险金，赔付后另外一个病种中症责任终止。
9.1.5意外导致的中度面部烧伤	指面部度烧伤且烧伤面积达到面部表面积的3/5或全身体表面积的1.8。体表面积根据中国新九分法计算，面部总面积为全身体表面积的3。面部面积不包括发部和颈部。因同一次意外事故原因所致的中度面积度烧伤、意外导致的中度面部烧伤，百年人寿仅赔付其中一项中症疾病保险金，赔付后另外一个病种中症责任终止。
9.1.6单个肢体缺失	指因疾病或意外伤害导致一个肢体自腕关节或踝关节近端（靠近躯干端）以上完全性断离。因糖尿病并发症引致的单个肢体缺失不在本保障范围内。
9.1.7中度系统性红斑狼疮	本项保障所指的系统性红斑狼疮必须符合下列所有理赔条件且未达到重大疾病系统性红斑狼疮性肾炎的给付标准：（1）在下列5项情况中出现最少3项：非畸形性关节炎或多关节痛；胸膜炎或心包炎；肾病：24小时尿蛋白定量达到0.5克；血象异常（白细胞小于4109/L或血小板小于100109/L或溶血性贫血）；抗dsDNA抗体阳性，或抗Sm抗体阳性，或抗核抗体阳性。（2）系统性红斑狼疮的诊断必须经专科医生确诊。
9.1.8中度脑炎或脑膜炎后遗症	指因患脑炎或者脑膜炎导致的神经系统的功能障碍。疾病确诊180天后，仍存在自主生活能力完全丧失，无法独立完成六项基本日常生活活动中的两项。
9.1.9中度运动神经元病	是一组中枢神经系统运动神经元的进行性变性疾病，进行性脊肌萎缩症、进行性延髓麻痹症、原发性侧索硬化症、肌萎缩性侧索硬化症。须满足自主生活能力部分丧失，无法独立完成六项基本日常生活活动中的两项。满足下列全部条件：（1）药物治疗无法控制病情；（2）自主生活能力完全丧失，无法独立完成六项基本日常生活活动中的两项。继发性帕金森综合征不在本保障范围内。
9.1.11结核性脊髓炎	指因结核杆菌引起的脊髓炎，导致永久性神经系统功能中度障碍，即：疾病首次确诊180天后，仍遗留下列障碍：自主生活能力部分丧失，无法独立完成六项基本日常生活活动中的二项或二项以上。该诊断必须由百年人寿认可的医疗机构内的神经专科医生证实，并必须由适当的检查证明为结核性脊髓炎。功能损害或呼吸无力。脊髓灰质炎必须明确诊断。本保险合同仅对脊髓灰质炎造成的神经系统功能损害导致被保险人一肢肢体机能永久完全丧失的情况予以理赔。肢体机能永久完全丧失，指疾病确诊180天后，该肢三大关节中的至少一个大关节仍然完全僵硬，或不能随意识活动。
9.1.13中度肠道疾病并发症	严重肠道疾病或外伤导致小肠损害并发症，本疾病须满足以下所有条件：（1）至少切除了二分之一小肠；（2）完全肠外营养支持二个月以上。因克隆病所致中度肠道疾病并发症不在本保障范围内。
9.1.14单侧肺脏切除	指因疾病或意外事故实际实施的一侧肺脏切除术。因药物滥用、酗酒、肺脏部分切除手术、肺脏捐献引起的手术不在本保障范围内。
9.1.15中度严重溃疡性结肠炎	溃疡性结肠炎是指伴有致命性电解质紊乱的大肠（结肠及直肠）粘膜炎症，病变累及全大肠。须满足下列所有条件：（1）须经由内窥镜检查证实该疾病侵犯全部结肠及直肠，并经病理学组织切片检查证实为溃疡性结肠炎；（2）经专科注册医生以类固醇或免疫抑制剂连续治疗6个月。诊断及治疗均须在百年人寿认可的医疗机构内由专科医师认为是医疗必须的情况下进行。
9.1.16中度进行性核上性麻痹	指一种少见的神经系统变性疾病，以假球麻痹、垂直性核上性眼肌麻痹、锥体外系肌僵直、步态共济失调和轻度痴呆为主要临床特征。须由百年人寿认可的医疗机构的专科医生确诊，且满足自主生活能力完全丧失，无法独立完成六项基本日常生活活动中的两项。
9.1.17中度克雅氏症	是一种传染性海绵状脑病，临床表现为快速进行性痴呆、肌阵挛和特征性脑电图变化。须由百年人寿认可的医疗机构的专科医生根据WHO诊断标准明确诊断，并且自主生活能力完全丧失，无法独立完成六项基本日常生活活动中的两项。
9.1.18中度克隆病	是一种慢性肉芽肿性肠炎，具有特征性的克隆病病理组织学变化。诊断必须由专科医生经过病理检查结果证实，被保险人所患的克隆症须经肠胃科专科医生以类固醇或免疫抑制剂连续治疗180天以上，且未达到重大疾病严重克隆病的给付标准。
9.1.19糖尿病并发症引致的单足截除	因糖尿病引起的神经及血管病变累及足部，为了维持生命已经实际进行由足踝或者以上位置的单足截除手术。手术须在百年人寿认可的医疗机构的专科医生认为是医疗必须的情况下进行。切除多只脚趾或者因其他原因引起的截除术不在本保障范围内。
9.1.20中度强直性脊柱炎	是一种慢性全身性炎性疾病，主要侵犯脊柱导致脊柱畸形。必须明确诊断并且满足下列所有条件且未达到重大疾病严重强直性脊柱炎的给付标准：（1）严重脊柱畸形；（2）自主生活能力完全丧失，无法独立完成六项基本日常生活活动中的两项或两项以上。
轻症疾病	
10.1轻症疾病	本合同所指轻症疾病，是被保险人经百年人寿认可的医院专科医生明确诊断，发生符合以下定义所述条件的疾病、疾病状态或手术，共计35种。轻症疾病名称及定义如下：
10.1.1极早期的恶性肿瘤或恶性病变	指经组织病理学检查被明确诊断为下列恶性病变，并且接受了相应的治疗。（1）原位癌；（2）相当于Binet分期方案A期程度的慢性淋巴细胞白血病；（3）相当于AnnArbor分期方案I期程度的何杰金氏病；（4）皮肤癌；（5）TNM分期为T1N0M0期或更轻分期的前列腺癌。原位癌：指恶性细胞局限于上皮内尚未穿破基底膜浸润周围正常组织的癌细胞新生物。原位癌必须经对固定活组织的组织病理学检查明确诊断。被保险人必须己经接受了针对原位癌病灶的积极治疗。
10.1.2不典型的急性心肌梗塞	指被临床诊断为急性心肌梗塞并接受了急性心肌梗塞治疗，虽然未达到重大疾病急性心肌梗塞的给付标准，但满足下列至少两项条件：（1）典型临床表现，例如急性胸痛等；（2）新近的心电图改变提示急性心肌梗塞；（3）心肌酶或肌钙蛋白有诊断意义的升高，或呈符合急性心肌梗塞的动态性变化；（4）发病90日后，经检查证实左心室功能降低，如左心室射血分数低于50。如被保险人同时或先后达到不典型的急性心肌梗塞、微创冠状动脉搭桥手术和微创冠状动脉介入手术（非开胸手术）的赔付标准，百年人寿仅赔付其中一项轻症疾病保险金；赔付后另外两个病种轻症责任终止。
10.1.3微创冠状动脉搭桥手术	指为纠正冠状动脉的狭窄或堵塞，而实际实施的微创冠状动脉旁路移植手术。手术通过微创开胸术（肋骨间小切口）进行，且诊断须由冠状动脉血管造影检查确诊狭窄或堵塞。微创冠状动脉绕道也包括锁孔冠脉搭桥手术。必须满足下列全部条件：（1）血管造影显示至少两支冠状动脉狭窄超过50或一支冠状动脉狭窄超过70；（2）手术须由心脏专科医师进行，并确认该手术的必要性。如被保险人同时或先后达到不典型的急性心肌梗塞、微创冠状动脉搭桥手术和微创冠状动脉介入手术（非开胸手术）的赔付标准，百年人寿仅赔付其中一项轻症疾病保险金；赔付后另外两个病种轻症责任终止。
10.1.4微创冠状动脉介入手术（非开胸手术）	为了治疗明显的冠状动脉狭窄性疾病，首次实际实施了冠状动脉球囊扩张成形术、冠状动脉支架植入术、冠状动脉粥样斑块切除术或激光冠状动脉成形术。如被保险人同时或先后达到不典型的急性心肌梗塞、微创冠状动脉搭桥手术和微创冠状动脉介入手术（非开胸手术）的赔付标准，百年人寿仅赔付其中一项轻症疾病保险金；赔付后另外两个病种轻症责任终止。
10.1.5心脏瓣膜介入手术	为了治疗心脏瓣膜疾病，实际实施了非开胸的经胸壁打孔内镜手术或经皮经导管介入手术进行的心脏瓣膜置换或修复手术。
10.1.6主动脉内手术	为了治疗主动脉疾病实际实施了经皮经导管进行的动脉内手术。主动脉指胸主动脉和腹主动脉，不包括胸主动脉和腹主动脉的分支血管。
10.1.7脑垂体瘤、脑囊肿、脑动脉瘤及脑血管瘤	指经头颅断层扫描（CT）、核磁共振（MRI）或其他影像学检查被确诊为下列病变，并实际接受了手术或放射治疗。（1）脑垂体瘤；（2）脑囊肿；（3）脑动脉瘤、脑血管瘤。如被保险人同时或先后达到脑垂体瘤、脑囊肿、脑动脉瘤及脑血管瘤和微创颅脑手术的赔付标准，百年人寿仅赔付其中一项轻症疾病保险金，赔付后另外一个病种轻症责任终止。
10.1.8微创颅脑手术	因疾病被保险人确已实施全麻下的颅骨钻孔手术或者经鼻蝶窦入颅手术。因外伤而实施的脑外科手术不在本保障范围内。如被保险人同时或先后达到脑垂体瘤、脑囊肿、脑动脉瘤及脑血管瘤和微创颅脑手术的赔付标准，百年人寿仅赔付其中一项轻症疾病保险金，赔付后另外一个病种轻症责任终止。
10.1.9慢性肝功能衰竭失代偿早期	指因慢性肝脏疾病导致持续180天肝功能衰竭，须满足下列全部条件：（1）持续性黄疸，胆红素2mg；（2）白蛋白3g；（3）凝血酶原时间延长4秒；因酗酒或药物滥用导致的肝功能衰竭不在本保障范围内。
10.1.10急性坏死性胰腺炎腹腔镜手术	指被保险人被确诊为急性坏死性胰腺炎，并实际接受了腹腔镜手术治疗，以进行坏死组织清除、坏死病灶切除或胰腺切除。因酗酒或饮酒过量所致的急性坏死性胰腺炎不在本保障范围内。
10.1.11慢性肾功能损害肾功能衰竭期	指被保险人因双肾功能慢性不可逆性损害，持续180天达到肾功能衰竭期，诊断必须满足所有以下标准：（1）肾小球滤过率（GFR）25ml/min或肌酐清除率（Ccr）25ml/min；（2）血肌酐（Scr）5mg/dl或442umol/L。股骨骨折。骨质疏松的诊断必须由本公司认可医院合格的专科医生做出，并符合世界卫生组织关于骨质疏松的诊断标准。世界卫生组织关于骨质疏松的定义：骨密度检测，T值小于2.5。
10.1.13轻度原发性肺动脉高压	指由于原发性肺动脉高压进行性发展而导致右心室肥厚，已经造成永久不可逆性的体力活动能力受限，达到美国纽约心脏病学会心功能状态分级级，且静息状态下肺动脉平均压超过25mmHg、不超过30mmHg。
10.1.14轻度视力受损	指因疾病或意外伤害导致双目视力永久不可逆性丧失，虽然未达到重大疾病双目失明的给付标准，但满足下列全部条件：（1）双眼中较好眼矫正视力低于0.1（采用国际标准视力表，如果使用其他视力表应进行换算）；（2）视野半径小于20度。在0周岁至3周岁期间，被保险人首次患有轻度视力受损除外。如被保险人同时或先后达到轻度视力受损、单眼失明和角膜移植的赔付标准，百年人寿仅赔付其中一项轻症疾病保险金，赔付后另外两个病种轻症责任终止。
10.1.15单眼失明	指因疾病或意外伤害导致单眼视力永久不可逆性丧失，须满足下列至少一项条件：（1）眼球缺失或摘除；（2）矫正视力低于0.02（采用国际标准视力表，如果使用其它视力表应进行换算）；（3）视野半径小于5度。在0周岁至3周岁期间，被保险人首次患有单眼失明除外。如被保险人同时或先后达到轻度视力受损、单眼失明和角膜移植的赔付标准，百年人寿仅赔付其中一项轻症疾病保险金，赔付后另外两个病种轻症责任终止。
10.1.16角膜移植	指为增进视力或治疗某些角膜疾患，已经实施了异体的角膜移植手术。此手术必须由专科医生认为是医学上必需的情况下进行。如被保险人同时或先后达到轻度视力受损、单眼失明和角膜移植的赔付标准，百年人寿仅赔付其中一项轻症疾病保险金，赔付后另外两个病种轻症责任终止。
10.1.17轻度听力受损	指因疾病或者意外伤害导致双耳听力永久不可逆性丧失，在500赫兹、1000赫兹和2000赫兹语音频率下，平均听阈大于70分贝，且经纯音听力测试、声导抗检测或者听觉诱发电位检测等证实。在0周岁至3周岁期间，被保险人首次患有轻度听力受损除外。如被保险人同时或先后达到轻度听力受损、单耳失聪和人工耳蜗植入术的赔付标准，百年人寿仅赔付其中一项轻症疾病保险金，赔付后另外两个病种轻症责任终止。
10.1.18单耳失聪	指因疾病或者意外伤害导致单耳听力永久不可逆性丧失，在500赫兹、1000赫兹和2000赫兹语音频率下，平均听阈大于90分贝，且经纯音听力测试、声导抗检测或者听觉诱发电位检测等证实。在0周岁至3周岁期间，被保险人首次患有单耳失聪除外。如被保险人同时或先后达到轻度听力受损、单耳失聪和人工耳蜗植入术的赔付标准，百年人寿仅赔付其中一项轻症疾病保险金，赔付后另外两个病种轻症责任终止。手术在医学上是必要的，且在植入手术之前已经符合下列全部条件：（1）双耳持续12个月以上重度感音神经性耳聋；（2）使用相应的听力辅助设备效果不佳。如被保险人同时或先后达到轻度听力受损、单耳失聪和人工耳蜗植入术的赔付标准，百年人寿仅赔付其中一项轻症疾病保险金，赔付后另外两个病种轻症责任终止。
10.1.20硬脑膜下血肿手术	为清除或引流因意外伤害导致的血肿，需于头部进行开颅或钻孔手术。开颅或钻孔手术必须在百年人寿认可的医疗机构内由专科医生认为是医疗必须的情况下进行。
10.1.21植入大脑内分流器	为缓解已升高的脑脊液压力而确实已在脑室进行分流器植入手术。诊断及治疗均须在百年人寿认可的医疗机构内由脑神经科专科医生认为是医疗必须的情况下进行。程度按照格拉斯哥昏迷分级（Glasgowcomascale）结果为5分或5分以下，且已经持续使用呼吸机及其它生命维持系统达到48小时，且未达到重大疾病深度昏迷的赔付标准。因酗酒或药物滥用导致的深度昏迷不在本保障范围内。
10.1.23因肾上皮质腺瘤切除肾上腺	因肾上腺皮质腺瘤所导致的醛固酮分泌过多而产生的继发性恶性高血压而实际接受了肾上腺切除术治疗。此诊断及治疗均须在百年人寿认可的医疗机构内由专科医生认为是医疗必须的情况下进行。
10.1.24心包膜切除术	因心包膜疾病导致已接受心包膜切除术或已进行任何需要心脏小切口技术的手术。手术必须在心脏科医生认为是医学上必需的情况下进行。
10.1.25于颈动脉进行血管成形术或内膜切除术	指根据颈动脉造影检查结果，确诊一条或以上颈动脉存在严重狭窄性病变（至少一支血管管腔直径减少50以上）。本病须经国家机关认可的有合法资质的专科医生明确诊断，同时必须已经采取以下手术以减轻症状：（1）确实进行动脉内膜切除术；或（2）确实进行血管介入治疗，例如血管成形术及或进行植入支架或动脉粥样瘤清除手术。
10.1.26腔静脉过滤器植入术	指经本公司认可医院的专科医生证明有反复肺栓塞发作及抗凝治疗无效而必须接受手术植入腔静脉过滤器。理赔时需提供完整病历及手术记录以证明植入腔静脉过滤器有必要性及已确实施行了手术。
10.1.27早期象皮病	指因丝虫感染导致淋巴管阻塞而造成身体组织出现严重淋巴水肿。此病症须经本公司认可医院的专科医生根据临床表现和微丝蚴的化验结果确诊。急性淋巴管炎或其它原因引起的淋巴水肿并不在本保障范围取
10.1.28心脏起搏器或除颤器植入	因严重心律失常而确实已行植入永久性心脏起搏器或除器的手术。理赔时须提供完整病历资料及手术记录以证实此严重心律失常并不能以其他方法治疗。诊断及治疗均须在百年人寿认可的医疗机构内由专科医生认为是医疗必须的情况下进行。
10.1.29早期原发性心肌病	被诊断为原发性心肌病，并符合下列所有条件：（1）导致心室功能受损，其受损程度达到美国纽约心脏病学会心脏功能分级的第级，即：体力活动明显受限，休息时无症状，轻于日常的活动可引起充血性心力衰竭的症状；（2）左室射血分数LVEF35；（3）原发性心肌病的诊断必须由本公司认可医院的心脏专科医生确认，并提供心脏超声检查结果报告。本保障范围内的心肌病包括扩张型心肌病、肥厚型心肌病及限制型心肌病，继发于酒精滥用性的心肌病不在此保障范围之内。
10.1.30较小面积度烧伤	指烧伤程度为度，且度烧伤面积达到全身体表面积的10或10以上，体表面积根据中国新九分法计算。
10.1.31肝脏切除	指因疾病或意外事故实际实施的肝脏部分切除术，手术须有至少一个完整的肝叶切除。因药物滥用、酗酒导致的肝脏损伤不在本保障范围内。肝脏捐献引起的手术不在本保障范围内。
10.1.32单侧肾脏切除	指因疾病或意外事故实际实施的一侧肾脏切除术。肾脏部分切除手术和肾脏捐献引起的手术不在本保障范围内。部分睾丸切除不在本保障范围。
10.1.34双侧卵巢切除术指为治疗疾病实际接受了经腹部切开或腹腔镜进行的双侧卵巢完全切除手	术。部分卵巢切除不在本保障范围。
10.1.35可逆性再生障碍性贫血	指因急性可逆性的骨髓造血功能衰竭而导致贫血、中性粒细胞减少和血小板减少，必须由血液科医生的诊断，且病历资料显示接受了下列任一治疗：（1）骨髓刺激疗法至少1个月；（2）免疫抑制剂治疗至少1个月。
