question	answer
1.1保险合同构成	本保险合同（以下简称本合同）指您与我们之间订立的国华康运一生重大疾病保险A款合同。本合同由保险单、保险条款、投保单，以及与本合同有关的投保文件、合法有效的声明、批注、批单和其他书面协议共同构成。
1.2保险合同成立与生效	您提出保险申请、我们同意承保，本合同成立。本合同自我们同意承保、收取首期保险费并签发保险单开始生效，具体生效日以保险单所载的日期为准。保单周年日（见9.1）、保单年度（见9.2）和保险费约定支付日（见9.3）均以本合同生效日计算。如当月无对应同一日，则以该月最后一日作为对应日。
1.3犹豫期	从您首次收到本合同并书面签收之日起的一段时期为犹豫期，该时期以保险单上所载的日数为准。在犹豫期内请您认真审视本合同，如果您认为本合同与您的需求不相符，您可以在此期间提出解除本合同，我们将会扣除不超过人民币10元的工本费后无息退还您所支付的保险费。解除本合同时，您需要填写解除合同申请书，并提供您的保险合同及有效身份证件（见9.4）。自我们收到您的解除合同申请书时起，本合同即被解除，合同解除前发生的保险事故我们不承担保险责任。
2.1保险期间	本合同的保险期间为终身。除合同另有约定外，本合同的保险期间自本合同生效日起，至被保险人身故时止。
2.2投保条件	您和被保险人必须符合以下条件：
投保人条件被保险人条件	凡年满18周岁（见9.5），具有完全民事行为能力且对被保险人具有保险利益的人，均可作为本合同的投保人。凡投保时身体健康，且符合我们承保条件的人，均可作为本合同的被保险人。
2.3基本保险金额	本合同的基本保险金额由您在投保时与我们约定并在保险单上载明，投保时的基本保险金额须符合我们当时的投保规定。
2.4保险责任	在本合同有效期内，我们承担如下保险责任：
等待期	在本合同生效或最后复效日(以较迟者为准)起180日内，被保险人因意外伤害事故（见9.6）以外的原因导致身故、或患本合同约定的重大疾病（见9.7）或轻症疾病（见9.8）的，我们不承担保险责任，我们向您退还本合同已交保险费，本合同终止。这180日的时间称为等待期。因意外伤害事故导致身故、或患本合同约定的重大疾病或轻症疾病的无等待期。如被保险人在等待期后发生本合同所约定的保险事故，我们按照下列方式给付保险金：
身故保险金	若被保险人身故，我们按以下情形之一的金额给付身故保险金，本合同终止。（1）若被保险人身故时未满18周岁，则为被保险人身故时本合同累计已交纳保险费；（2）若被保险人身故时已满18周岁（含18周岁），则为本合同基本保险金额。
重大疾病保险金	被保险人初次发生（见9.9）并被医院（见9.10）的专科医生（见9.11）确诊患有本合同约定的重大疾病，我们按本合同基本保险金额给付重大疾病保险金，本合同终止。上述身故保险金、重大疾病保险金两项保险金，我们仅给付其中一项，给付后，本合同终止。
轻症疾病保险金	被保险人初次发生并被医院的专科医生确诊患有本合同约定的轻症疾病，我们按本合同基本保险金额的20给付轻症疾病保险金。每种轻症疾病的轻症疾病保险金最多只给付一次。轻症疾病保险金的累计给付次数不超过三次，若轻症疾病保险金的累计给付次数达到三次，该项保险责任终止。
轻症疾病豁免保险费	被保险人初次发生并被医院的专科医生确诊患有本合同约定的轻症疾病，则自确诊日后首个本合同的保险费约定支付日开始，直至本合同最后一次保险费约定支付日止，我们豁免前述期间内本合同的应交保险费。被豁免的保险费视为已交纳，本合同继续有效。如被保险人确诊初次发生本合同约定的轻症疾病的同时或之前，确诊发生了本合同约定的重大疾病，我们只给付重大疾病保险金，不再承担轻症疾病相应的保险责任。
2.5责任免除	因下列第（1）至第（7）项情形之一导致被保险人身故的，我们不承担给付身故保险金的责任；因下列第（1）至第（9）项情形之一导致被保险人发生重大疾病或轻症疾病的，我们不承担相应保险责任：(1)投保人对被保险人的故意杀害、故意伤害；(2)被保险人自本合同成立或者合同效力恢复之日起2年内自杀，但被保险人自杀时为无民事行为能力人的除外；(3)被保险人故意自伤、故意犯罪或抗拒依法采取的刑事强制措施；(4)被保险人酗酒（见9.12）、殴斗、服用、主动吸食或注射毒品（见9.13），违反规定使用麻醉或精神药品，未遵医嘱私自服用、涂用、注射药物；(5)被保险人酒后驾驶（见9.14）、无合法有效驾驶证驾驶（见9.15），或驾驶无有效行驶证照（见9.16）的机动车（见9.17）；(6)战争、军事冲突、暴乱或武装叛乱；(7)核爆炸、核辐射或核污染；(8)被保险人感染艾滋病病毒或患艾滋病（见9.18）期间因疾病导致的（但符合本合同经输血导致的人类免疫缺陷病毒感染或因职业关系导致的人类免疫缺陷病毒（HIV）感染定义的不在此限）；(9)遗传性疾病（见9.19），先天性畸形、变形或染色体异常（见9.20）。发生上述第（1）项情形导致被保险人身故、发生重大疾病或轻症疾病的，本合同终止，您已交足2年以上保险费的，我们向其他权利人退还合同效力终止之日本合同的现金价值（见9.21）。其他权利人按照被保险人、被保险人继承人的顺序确定。发生上述第（2）项至第（7）项情形导致被保险人身故的，本合同终止，我们向您退还被保险人身故时本合同的现金价值。发生上述第（2）项至第（9）项情形导致被保险人发生重大疾病或轻症疾病的，本合同终止，我们向您退还合同效力终止之日本合同的现金价值。
3.1受益人	您或者被保险人可以指定一人或者多人为身故保险金受益人。身故保险金受益人为多人时，可以确定受益顺序和受益份额；如果没有确定受益份额，各受益人按照相等份额享有受益权。被保险人为无民事行为能力人或限制民事行为能力人的，可以由其监护人指定受益人。您或者被保险人可以变更身故保险金受益人并书面通知我们，我们收到变更受益人的书面通知后，在保险单或其他保险凭证上批注或者附贴批单，变更自我们在保险单或者其他保险凭证上批注或者附贴批单之日起产生效力。您在指定和变更身故保险金受益人时，必须经过被保险人书面同意。除另有约定外，疾病保险金受益人为被保险人本人。被保险人身故后，遇有下列情形之一的，保险金作为被保险人的遗产，由我们依照中华人民共和国继承法的规定履行给付保险金的义务：（1）没有指定受益人，或者受益人指定不明无法确定的；（2）受益人先于被保险人身故，没有其他受益人的；（3）受益人依法丧失受益权或者放弃受益权，没有其他受益人的。受益人与被保险人在同一事件中身故，且不能确定身故先后顺序的，推定受益人身故在先。受益人故意造成被保险人身故、伤残、疾病的，或者故意杀害被保险人未遂的，该受益人丧失受益权。
3.2保险事故通知	您或受益人知道保险事故后应当在10日内通知我们。如果您或受益人故意或者因重大过失未及时通知，致使保险事故的性质、原因、损失程度等难以确定的，我们对无法确定的部分，不承担给付保险金的责任，但我们通过其他途径已经及时知道或者应当及时知道保险事故发生或者虽未及时通知但不影响我们确定保险事故的性质、原因、损失程度的除外。
3.3保险金或者豁免保险费申请	在申请保险金或者申请豁免保险费时，请按照下列方式办理：
重大疾病保险金、轻症疾病保险金、轻症疾病豁免保险费申请	在申请重大疾病保险金、轻症疾病保险金或者轻症疾病豁免保险费时，申请人须填写保险金给付申请书或者豁免保险费申请书，并提供下列证明和资料：（1）保险合同；（2）申请人的有效身份证件；（3）医院的专科医生出具的附有病理显微镜检查、血液检验及其他科学方法检验报告的、诊断结论符合9.7重大疾病或9.8轻症疾病所列举情形的疾病诊断证明书；（4）所能提供的与确认保险事故的性质、原因等有关的其他证明和资料。以上证明和资料不完整的，我们将及时一次性通知申请人补充提供有关证明和资料。
身故保险金申请	在申请身故保险金时，申请人须填写保险金给付申请书，并提供下列证明和资料：（1）保险合同；（2）申请人的有效身份证件；（3）国家卫生行政部门认定的医疗机构（见9.22）、公安部门或其他相关机构出具的被保险人的死亡证明；（4）如被保险人为宣告死亡，须提供法院出具的宣告死亡判决书和被保险人户籍注销证明；（5）所能提供的与确认保险事故的性质、原因等有关的其他证明和资料。保险金作为被保险人遗产时，必须提供可证明合法继承权的相关权利文件。以上证明和资料不完整的，我们将及时一次性通知申请人补充提供有关证明和资料。
3.4保险金给付	我们在收到保险金给付申请书或豁免保险费申请书及合同约定的证明和资料后，将在5日内作出核定；情形复杂的，在30日内作出核定。但因第三方责任或其他非我们的责任导致保险事故的性质、金额无法确定的除外。对确定属于保险责任的，在与受益人达成有关给付保险金数额的协议后10日内，履行给付保险金义务。我们未及时履行前款规定义务的，除支付保险金外，应当赔偿受益人因此受到的损失。对不属于保险责任的，我们自作出核定之日起3日内向受益人发出拒绝给付保险金通知书并说明理由。我们在收到保险金给付申请书或豁免保险费申请书及有关证明和资料之日起60日内，对给付保险金的数额不能确定的，根据已有证明和资料可以确定的数额先予支付；我们最终确定给付保险金的数额后，将支付相应的差额。
3.5失踪处理	在本合同有效期内，如果被保险人因本合同约定的保险事故失踪且被法院宣告死亡，我们以法院判决宣告死亡之日作为被保险人的死亡时间，按本合同的约定给付身故保险金，本合同终止。如果被保险人在宣告死亡后重新出现或者受益人确知其没有死亡的，受益人应于知道后30日内向我们退还已给付的保险金，本合同的效力依法确定。
3.6诉讼时效	受益人向我们请求给付身故保险金的诉讼时效期间为5年，其余保险金的诉讼时效期间为2年，自其知道或者应当知道保险事故发生之日起计算。
4.1保险费的支付	本合同的交费方式和交费期间由您和我们约定并在保险单上载明。您应当按照本合同约定向我们支付保险费。如果您选择分期支付保险费，您在支付首期保险费后，应在每期保险费约定支付日或之前支付对应各期的保险费。
4.2宽限期	分期支付保险费的，您支付首期保险费后，除本合同另有约定外，如果您到期未支付保险费，自保险费约定支付日的次日零时起60日为宽限期。宽限期内发生的保险事故，我们仍会承担保险责任，但在给付保险金时会扣减您欠交的保险费。如果您在宽限期结束之后仍未支付保险费，则本合同自宽限期满的次日零时起效力中止。
5.1现金价值	本合同保单年度末的现金价值会在保险单上载明。保单年度内的现金价值，您可以向我们咨询。
5.2保险费的自动垫交	若您在投保时选择了或宽限期结束前书面同意了保险费的自动垫交，并且您在宽限期结束时仍未支付保险费，本合同及其附加合同当时的现金价值净额（见9.23）足以垫交到期应交保险费的，我们将以现金价值净额自动垫交本合同及其附加合同的到期应交保险费，使本合同及其附加合同继续有效。若本合同及其附加合同当时的现金价值净额不足以垫交一期保险费的，我们按当时本合同及其附加合同的现金价值净额计算本合同及其附加合同可以继续有效的日数。当现金价值净额小于零时，本合同及其附加合同效力即行中止。我们为您垫交的保险费将按照本条款约定利率（见9.24）以年复利方式计算并收取利息。
5.3保单贷款	在本合同有效期内，经我们同意，您可以凭保险单向我们申请贷款。贷款金额不得超过本合同及其附加合同现金价值净额的80，每次贷款期限最长不超过6个月。贷款本金及利息（按本条款约定利率计算）在贷款到期时一并归还。若您到期未能足额偿还贷款本金及利息，则您所欠的贷款本金及利息将作为新的贷款本金计息。当未还贷款本金及利息加上其他各项欠款达到本合同及其附加合同现金价值时，本合同及其附加合同效力即行中止。如已发生保险金给付的，您不得申请保单贷款。
6.1效力中止	出现下列情况之一，本合同效力中止。（1）当支付保险费宽限期结束时，您仍未支付应交保险费，且您未选择保险费自动垫交；（2）因自动垫交保险费或保单贷款导致本合同现金价值净额小于零时。在本合同效力中止期间，我们不承担保险责任。
6.2效力恢复	本合同效力中止后2年内，您可以申请恢复合同效力。经我们与您协商并达成协议，在您补交保险费、偿还保单贷款及利息、及其他未还款项之日起，合同效力恢复。自本合同效力中止之日起满2年您和我们未达成协议的，我们有权解除合同。我们解除合同的，向您退还合同效力中止时本合同的现金价值。
7.1您解除合同的手续及风险	如您在犹豫期后申请解除本合同（简称退保），请填写解除合同申请书并向我们提供下列资料：（1）保险合同；（2）您的有效身份证件。自我们收到解除合同申请书时起，本合同终止。我们自收到解除合同申请书之日起30日内，向您退还收到解除合同申请书之日本合同的现金价值。您在犹豫期后解除合同会遭受一定损失。除另有约定外，如已发生保险金给付的，您不得要求解除本合同。
8.1未还款项	我们在给付各项保险金、退还现金价值或退还保险费时，如果有您欠交的保险费或其他未还清款项，我们会在扣除上述欠款及应付利息后给付。
8.2明确说明与如实告知	订立本合同时，我们应向您说明本合同的内容。对保险条款中免除我们责任的条款，我们在订立合同时应当在投保单、保险单或者其他保险凭证上作出足以引起您注意的提示，并对该条款的内容以书面或者口头形式向您作出明确说明，未作提示或者明确说明的，该条款不产生效力。我们就您和被保险人的有关情况提出询问，您应当如实告知。如果您故意或者因重大过失未履行前款规定的如实告知义务，足以影响我们决定是否同意承保或者提高保险费率的，我们有权解除本合同。如果您故意不履行如实告知义务，对于本合同解除前发生的保险事故，我们不承担给付保险金的责任，并不退还保险费。如果您因重大过失未履行如实告知义务，对保险事故的发生有严重影响的，对于本合同解除前发生的保险事故，我们不承担给付保险金的责任，但应当退还保险费。我们在合同订立时已经知道您未如实告知的情况的，我们不得解除合同；发生保险事故的，我们承担给付保险金的责任。
8.3我们合同解除权的限制	前条规定的合同解除权，自我们知道有解除事由之日起，超过30日不行使而消灭。自本合同成立之日起超过2年的，我们不得解除合同；发生保险事故的，我们承担给付保险金的责任。
8.4未成年人身故保险金限制	为未成年子女投保的人身保险，因被保险人身故给付的保险金总和不得超过国务院保险监督管理机构规定的限额，身故给付的保险金额总和约定也不得超过前述限额。
8.5年龄性别错误	您在申请投保时，应将与有效身份证件相符的被保险人的出生日期和性别在投保单上填明，如果发生错误按照下列方式办理：（1）您申报的被保险人年龄不真实，并且真实年龄不符合本合同约定投保年龄限制的，在保险事故发生之前我们有权解除合同，并向您退还本合同的现金价值。我们行使合同解除权适用我们合同解除权的限制的规定。（2）您申报的被保险人年龄或性别不真实，致使您实付保险费少于应付保险费的，我们有权更正并要求您补交保险费；若已经发生保险事故，在给付保险金时按实付保险费和应付保险费的比例给付。（3）您申报的被保险人年龄或性别不真实，致使您实付保险费多于应付保险费的，我们会将多收的保险费退还给您。
8.6合同内容变更	在本合同有效期内，经您与我们协商一致，可以变更本合同内容。变更本合同内容的，应当由我们在保险单或其他保险凭证上批注或附贴批单，或由您与我们订立书面的变更协议。
8.7职业或工种变更	被保险人变更职业或工种时，您或被保险人应于10日内以书面形式通知我们。被保险人所变更的职业或者工种依照我们的职业分类在拒保范围内的，我们收到通知后，对被保险人的保险责任自被保险人职业、工种变更之日起终止，向您退还被保险人职业、工种变更之日本合同的现金价值。被保险人所变更的职业或工种依照我们的职业分类在拒保范围内的，但未依上述约定通知我们，且发生保险事故的，我们不承担给付保险金的责任。但会向您退还被保险人职业、工种变更之日本合同的现金价值。
8.8联系方式变更	为了保障您的合法权益，您的住所、通讯地址或电话等联系方式变更时，请及时以书面形式或双方认可的其他形式通知我们。若您未以书面形式或双方认可的其他形式通知我们，我们按本合同载明的最后住所或通讯地址发送的有关通知，均视为已送达给您。
8.9争议处理	合同争议解决方式由当事人在合同约定时从下列两种方式中选择一种：（1）因履行本合同发生的争议，由当事人协商解决，协商不成的，提交仲裁委员会仲裁；（2）因履行本合同发生的争议，由当事人协商解决，协商不成的，依法向被告住所地人民法院起诉。
释义	
9.1保单周年日	指在本合同有效期内，本合同生效日在合同生效后每年的对应日，不含本合同生效日当日。若当月没有对应的同一日，则以该月最后一日为对应日。
9.2保单年度	指在本合同有效期内，从本合同生效日或保单周年日零时起至下一年度的保单周年日零时止为一个保单年度。
9.3保险费约定支付日	根据本合同交费方式确定的本合同生效日在每月、每季、每半年或每年的对应日。如果当月无对应的同一日，则以该月最后一日为对应日。
9.4有效身份证件	指由政府主管部门规定的证明其身份的证件，如：居民身份证、按规定可使用的有效护照、军官证、武警警官证、士兵证等证件。
9.5周岁	指按有效身份证件中记载的出生日期计算的年龄，自出生之日起为零周岁，每经过一年增加一岁，不足一年的不计。
9.6意外伤害事故	指外来的、非本意的、突然的、非疾病的使被保险人身体受到伤害的客观事件。猝死不属于意外伤害事故。其中，猝死：指表面健康的人因潜在疾病、机能障碍或其他原因在出现症状后24小时内发生的非暴力性突然死亡。猝死的认定以医院的诊断和公安部门的鉴定为准。
9.7重大疾病	本合同所指的重大疾病（共61种），是指符合下列定义的疾病、疾病状态或手术：以下25种重大疾病定义是由中国保险行业协会与中国医师协会共同制定的重大疾病保险的疾病定义。（一）恶性肿瘤指恶性细胞不受控制的进行性增长和扩散，浸润和破坏周围正常组织，可以经血管、淋巴管和体腔扩散转移到身体其它部位的疾病。经病理学检查结果明确诊断，临床诊断属于世界卫生组织疾病和有关健康问题的国际统计分类（ICD10）的恶性肿瘤范畴。下列疾病不在保障范围内：（1）原位癌；（2）相当于Binet分期方案A期程度的慢性淋巴细胞白血病；（3）相当于AnnArbor分期方案I期程度的何杰金氏病；（4）皮肤癌（不包括恶性黑色素瘤及已发生转移的皮肤癌）；（5）TNM分期为T1N0M0期或更轻分期的前列腺癌；（6）感染艾滋病病毒或患艾滋病期间所患恶性肿瘤。（二）急性心肌梗塞指因冠状动脉阻塞导致的相应区域供血不足造成部分心肌坏死。须满足下列至少三项条件：（1）典型临床表现，例如急性胸痛等；（2）新近的心电图改变提示急性心肌梗塞；（3）心肌酶或肌钙蛋白有诊断意义的升高，或呈符合急性心肌梗塞的动态性变化；（4）发病90天后，经检查证实左室功能降低的，如左心室射血分数低于50。（三）脑中风后遗症指因脑血管的突发病变引起脑血管出血、栓塞或梗塞，并导致神经系统永久性功能障碍。神经系统永久性的功能障碍，指疾病确诊180天后，仍遗留下列一种或一种以上障碍：（1）一肢或一肢以上肢体机能完全丧失；（2）语言能力或咀嚼吞咽能力完全丧失；（3）自主生活能力完全丧失，无法独立完成六项基本日常生活活动中的三项或三项以上。（四）重大器官移植术或造血干细胞移植术重大器官移植术，指因相应器官功能衰竭，已经实施了肾脏、肝脏、心脏或肺脏的异体移植手术。造血干细胞移植术，指因造血功能损害或造血系统恶性肿瘤，已经实施了造血干细胞（包括骨髓造血干细胞、外周造血干细胞和脐血造血干细胞）的异体移植手术。（五）冠状动脉搭桥术指为治疗严重的冠心病，实际实施了开胸进行的冠状动脉血管旁路移植的手术。冠状动脉支架植入手术、心导管球囊扩张术、激光射频技术及其他非开胸的介入手术、腔镜手术不在保障范围内。（六）终末期肾病指双肾功能慢性不可逆性衰竭，达到尿毒症期，经诊断后已经进行了至少90天的规律性透析治疗或实施了肾脏移植手术。（七）多个肢体缺失指因疾病或意外伤害导致两个或两个以上肢体自腕关节或踝关节近端（靠近躯干端）以上完全性断离。（八）急性或亚急性重症肝炎指因肝炎病毒感染引起肝组织弥漫性坏死，导致急性肝功能衰竭，且经血清学或病毒学检查证实，须满足下列全部条件：（1）重度黄疸或黄疸迅速加重；（2）肝性脑病；（3）B超或其他影像学检查显示肝脏体积急速萎缩；（4）肝功能指标进行性恶化。（九）良性脑肿瘤指脑的良性肿瘤，已经引起颅内压增高，临床表现为视神经乳头水肿、精神症状、癫痫及运动感觉障碍等，并危及生命。须由头颅断层扫描（CT）、核磁共振检查（MRI）或正电子发射断层扫描（PET）等影像学检查证实，并须满足下列至少一项条件：（1）实际实施了开颅进行的脑肿瘤完全切除或部分切除的手术；（2）实际实施了对脑肿瘤进行的放射治疗。脑垂体瘤、脑囊肿、脑血管性疾病不在保障范围内。（十）慢性肝功能衰竭失代偿期指因慢性肝脏疾病导致肝功能衰竭，须满足下列全部条件：（1）持续性黄疸；（2）腹水；（3）肝性脑病；（4）充血性脾肿大伴脾功能亢进或食管胃底静脉曲张。因酗酒或药物滥用导致的肝功能衰竭不在保障范围内。（十一）脑炎后遗症或脑膜炎后遗症指因患脑炎或脑膜炎导致的神经系统永久性的功能障碍。神经系统永久性的功能障碍，指疾病首次确诊180天后，仍残留下列一种或一种以上障碍：（1）一肢或一肢以上肢体机能完全丧失；（2）语言能力或咀嚼吞咽能力完全丧失；（3）自主生活能力完全丧失，无法独立完成六项基本日常生活活动中的三项或三项以上。（十二）深度昏迷指因疾病或意外伤害导致意识丧失,对外界刺激和体内需求均无反应，昏迷程度按照格拉斯哥昏迷分级（Glasgowcomascale）结果为5分或5分以下，且已经持续使用呼吸机及其它生命维持系统96小时以上。由于酗酒或药物滥用导致的深度昏迷不在保障范围内。（十三）双耳失聪指因疾病或意外伤害导致双耳听力永久不可逆性丧失，在500赫兹、1000赫兹和2000赫兹语音频率下，平均听阈大于90分贝，且经纯音听力测试、声导抗检测或听觉诱发电位检测等证实。被保险人申请理赔时年龄必须在三周岁以上，并且提供理赔当时的听力丧失诊断及检查证据。（十四）双目失明指因疾病或意外伤害导致双目视力永久不可逆性丧失，双眼中较好眼须满足下列至少一项条件：（1）眼球缺失或摘除；（2）矫正视力低于0.02（采用国际标准视力表，如果使用其他视力表应进行换算）；（3）视野半径小于5度。被保险人申请理赔时年龄必须在三周岁以上，并且提供理赔当时的视力丧失诊断及检查证据。（十五）瘫痪指因疾病或意外伤害导致两肢或两肢以上肢体机能永久完全丧失。肢体机能永久完全丧失，指疾病确诊180天后或意外伤害发生180天后，每肢三大关节中的两大关节仍然完全僵硬，或不能随意识活动。（十六）心脏瓣膜手术指为治疗心脏瓣膜疾病，实际实施了开胸进行的心脏瓣膜置换或修复的手术。（十七）严重阿尔茨海默病指因大脑进行性、不可逆性改变导致智能严重衰退或丧失，临床表现为明显的认知能力障碍、行为异常和社交能力减退，其日常生活必须持续受到他人监护。须由头颅断层扫描（CT）、核磁共振检查（MRI）或正电子发射断层扫描（PET）等影像学检查证实，自主生活能力完全丧失，无法独立完成六项基本日常生活活动中的三项或三项以上。神经官能症和精神疾病不在保障范围内。（十八）严重脑损伤指因头部遭受机械性外力，引起脑重要部位损伤，导致神经系统永久性的功能障碍。须由头颅断层扫描（CT）、核磁共振检查（MRI）或正电子发射断层扫描（PET）等影像学检查证实。神经系统永久性的功能障碍，指脑损伤180天后，仍遗留下列一种或一种以上障碍：（1）一肢或一肢以上肢体机能完全丧失；（2）语言能力或咀嚼吞咽能力完全丧失；（3）自主生活能力完全丧失，无法独立完成六项基本日常生活活动中的三项或三项以上。（十九）严重帕金森病指一种中枢神经系统的退行性疾病，临床表现为震颤麻痹、共济失调等。须满足下列全部条件：（1）药物治疗无法控制病情；（2）自主生活能力完全丧失，无法独立完成六项基本日常生活活动中的三项或三项以上。继发性帕金森综合征不在保障范围内。（二十）严重III度烧伤指烧伤程度为度，且度烧伤面积达到全身体表面积的20或20以上。体表面积根据中国新九分法计算。（二十一）严重原发性肺动脉高压指不明原因的肺动脉压力持续性增高，进行性发展而导致的慢性疾病，已经造成永久不可逆性的体力活动能力受限，达到美国纽约心脏病学会心功能状态分级IV级，静息状态下肺动脉平均压超过30mmHg。（二十二）严重运动神经元病是一组中枢神经系统运动神经元的进行性变性疾病，包括进行性脊肌萎缩症、进行性延髓麻痹症、原发性侧索硬化症、肌萎缩性侧索硬化症。须满足自主生活能力完全丧失，无法独立完成六项基本日常生活活动中的三项或三项以上。（二十三）语言能力丧失指因疾病或意外伤害导致完全丧失语言能力，经过积极治疗至少12个月（声带完全切除不受此时间限制），仍无法通过现有医疗手段恢复。精神心理因素所致的语言能力丧失不在保障范围内。被保险人申请理赔时年龄必须在三周岁以上，并且提供理赔当时的语言能力丧失诊断及检查证据。（二十四）重型再生障碍性贫血指因骨髓造血功能慢性持续性衰竭导致的贫血、中性粒细胞减少及血小板减少，须满足下列全部条件：（1）骨髓穿刺检查或骨髓活检结果支持诊断；（2）外周血象必须具备以下三项条件：中性粒细胞绝对值0.510/L；网织红细胞1；血小板绝对值2010/L。（二十五）主动脉手术指为治疗主动脉疾病，实际实施了开胸或开腹进行的切除、置换、修补病损主动脉血管的手术。主动脉指胸主动脉和腹主动脉，不包括胸主动脉和腹主动脉的分支血管。动脉内血管成形术不在保障范围内。以下36种重大疾病定义是本公司在中国保险行业协会与中国医师协会共同制定的重大疾病保险的疾病种类范围以外增加的疾病定义。（二十六）慢性呼吸功能衰竭慢性肺部疾病导致永久不可逆性的慢性呼吸功能衰竭，必须由呼吸专科医生确认并符合下列所有条件：（1）休息时出现呼吸困难；（2）动脉血氧分压（PaO）50mmHg；（3）动脉血氧饱和度（SaO）80；（4）因缺氧必须接受持续的输氧治疗。（二十七）严重多发性硬化多发性硬化为中枢神经系统白质多灶性脱髓鞘病变，病变有时累及灰质。多发性硬化必须明确诊断，并且已经造成神经系统功能损害导致被保险人永久不可逆性的无法独立完成下列基本日常生活活动：（1）移动：自己从一个房间移动到另一个房间；或者（2）进食：自己从已准备好的碗或碟中取食物放入口中。（二十八）严重冠心病指经心脏科专科医师根据冠状动脉造影检查结果确诊为主要血管严重狭窄性病变，须满足下列至少一项条件：（1）左冠状动脉主干和右冠状动脉中，一支血管管腔堵塞75以上，另一支血管管腔堵塞60以上；（2）前降支、回旋支和右冠状动脉中，至少一支血管管腔堵塞75以上，其他两支血管管腔堵塞60以上。前降支的分支血管、左旋支的分支血管及右冠状动脉的分支血管的狭窄不作为本保障的衡量指标。（二十九）严重心肌病严重心肌病指被保人因心肌病导致慢性心功能损害造成心功能衰竭（指按照美国纽约心脏协会心功能分类标准心功能达级），且有相关住院医疗记录显示级心功能衰竭状态持续至少180天。美国纽约心脏协会分类标准心功能级是指有医院的医疗记录显示病人不能进行任何活动，休息时仍有心悸、呼吸困难等心力衰竭表现。（三十）系统性红斑狼疮III型或III型以上狼疮性肾炎系统性红斑狼疮是由多种因素引起，累及多系统的自身免疫性疾病。其特点是生成自身抗体对抗多种自身抗原。本合同所指的系统性红斑狼疮仅限于累及肾脏（经肾脏活检确认的，符合WHO诊断标准定义III型或III型以上狼疮性肾炎）的系统性红斑狼疮。其他类型的红斑性狼疮，如盘状狼疮、仅累及血液及关节的狼疮不在本合同保障范围取１静”匦胗擅庖吆头缡科专家医师确诊。世界卫生组织（WHO）狼疮性肾炎分型：I型微小病变型II型系膜病变型III型局灶及节段增生型IV型弥漫增生型V型膜型VI型肾小球硬化型（三十一）经输血导致的人类免疫缺陷病毒感染被保险人感染上人类免疫缺陷病毒（HIV）并且满足下列全部条件：（1）在保障起始日或复效日之后，被保险人因输血而感染HIV；（2）提供输血治疗的输血中心或医院出具该项输血感染属医疗责任事故的报告，或者法院终审裁定为医疗责任并且不准上诉；（3）受感染的被保险人不是血友病患者。在任何治愈艾滋病（AIDS）或阻止HIV病毒作用的疗法被发现以后，或能防止AIDS发生的医疗方法被研究出来以后，本保障将不再予以赔付。任何因其他传播方式（包括：性传播或静脉注射毒品）导致的HIV感染不在本合同保障范围内。保险公司必须拥有获得使用被保险人的所有血液样本的权利和能够对这些样本进行独立检验的权利。（三十二）因职业关系导致的人类免疫缺陷病毒（HIV）感染被保险人在其常规职业工作过程中遭遇外伤，或者职业需要处理血液或者其他体液时感染上人类免疫缺陷病毒（HIV）。必须满足下列全部条件：（1）感染必须是在被保险人正在从事其职业工作中发生，该职业必须属于以下列表内的职业；（2）血清转化必须出现在事故发生后的6个月以内；（3）必须提供被保险人在所报事故发生后的5天以内进行的检查报告，该报告必须显示被保险人血液HIV病毒阴性和/或HIV抗体阴性；（4）必须在事故发生后的12个月内证实被保险人体内存在HIV病毒或者HIV抗体。职业限制如下所示:医生和牙科医生护士实验室工作人员医院护工医生助理和牙医助理救护车工作人员助产士消防队员警察狱警（三十三）脊髓灰质炎脊髓灰质炎是由于脊髓灰质炎病毒感染所致的瘫痪性疾病，临床表现为运动功能损害或呼吸无力。脊髓灰质炎必须明确诊断。本合同仅对脊髓灰质炎造成的神经系统功能损害导致被保险人一肢或一肢以上肢体机能永久完全丧失的情况予以理赔。肢体机能永久完全丧失，指疾病确诊180天后，每肢三大关节中的两大关节仍然完全僵硬，或不能随意识活动。（三十四）特发性慢性肾上腺皮质功能减退指自身免疫性肾上腺炎（既往称：特发性肾上腺皮质萎缩）导致肾上腺萎缩和慢性肾上腺皮质功能减退。必须满足所有以下条件：（1）明确诊断，符合所有以下诊断标准：血浆促肾上腺皮质激素(ACTH)水平测定，100pg/ml；血浆肾素活性、血管紧张素II和醛固酮测定，显示为原发性肾上腺皮质功能减退症；促肾上腺皮质激素(ACTH)刺激试验显示为原发性肾上腺皮质功能减退症。（2）已经采用皮质类固醇替代治疗180天以上。（3）肾上腺结核、HIV感染或艾滋病、感染、肿瘤所致的原发性肾上腺皮质功能减退和继发性肾上腺皮质功能减退不在本保障范围内。（三十五）自主生活能力完全丧失指严重疾病或外伤造成被保险人永久不可逆的身体功能损害，导致自主生活能力完全丧失，被保险人年龄在6周岁以上且至少持续180天以上无法独立完成六项基本日常生活活动中的三项或三项以上。（三十六）植物人状态植物人状态系指成大脑和/或脑干严重损害导致完全永久性的对自身和环境的意识丧失和中枢神经系统功能丧失，仅残存植物神经功能的疾病状态。必须经神经科医生确诊并且具有严重脑损害的证据。植物人状态必须持续30天以上方可申请理赔。（三十七）全身性重症肌无力重症肌无力是一种神经肌肉接头传递障碍所致的疾病，表现为局部或全身骨骼肌（特别是眼外肌）极易疲劳。疾病可以累及呼吸肌、上肢或下肢的近端肌群或全身肌肉，必须满足下列全部条件：（1）经药物治疗和胸腺切除治疗一年以上仍无法控制病情；（2）自主生活能力完全丧失，无法独立完成六项基本日常生活活动中的三项或三项以上。（三十八）重症急性坏死性筋膜炎是一种由细菌侵入皮下组织和筋膜引起的急性坏死性软组织感染，可伴有毒血症、败血症、中毒性休克、弥漫性血管内凝血及多器官衰竭。必须满足以下所有条件：（1）细菌培养和临床表现符合坏死性筋膜炎诊断标准；（2）病情迅速恶化，有脓毒血症表现；（3）受感染肢体被截肢（自腕关节或踝关节近端）。（三十九）严重类风湿性关节炎类风湿性关节炎为广泛分布的慢性进行性多关节病变，表现为关节严重变形，侵犯至少三个主要关节或关节组如：双手（多手指）关节、双足（多足趾）关节、双腕关节、双膝关节和双髋关节。类风湿性关节炎必须明确诊断并且已经达到类风湿性关节炎功能分类IV级的永久不可逆性关节功能障碍（生活不能自理，且丧失工作能力）并且满足下列全部条件：（1）晨僵；（2）对称性关节炎；（3）类风湿性皮下结节；（4）类风湿因子滴度升高；（5）X线显示严重的关节（软骨和骨）破坏和关节畸形。（四十）严重克隆病克隆病是一种慢性肉芽肿性肠炎，具有特征性的克隆病病理组织学变化。诊断必须由病理检查结果证实。被保险人所患的克隆病必须已经造成瘘管形成并伴有肠梗阻或肠穿孔。（四十一）严重溃疡性结肠炎本合同所保障的溃疡性结肠炎是指伴有致命性电解质紊乱的急性暴发性溃疡性结肠炎，病变累及全结肠，表现为严重的血便和系统性症状体征，治疗通常采取全结肠切除和回肠造瘘术。溃疡性结肠炎必须根据组织病理学特点诊断，并且被保险人已经接受了结肠切除和/或回肠造瘘术。（四十二）严重原发性硬化性胆管炎为一种特发型淤胆性疾病，特点为肝内及肝外胆道系统胆管壁增厚和管腔狭窄。必须满足以下所有条件：（1）诊断由逆行胰胆管造影（ERCP）或经皮胆管造影（PTC）确认；（2）持续性黄疸伴碱性磷酸酶显著升高（血清ALP200）；（3）出现继发性胆汁性肝硬化和门静脉高压。（四十三）II级重症急性胰腺炎级重症急性胰腺炎是指急性胰腺炎伴有脏器功能障碍。被保险人所患的级重症急性胰腺炎必须明确诊断，按APACHE评分达到8分或8分以上和Balthazar分级系统达到级或级以上，并且接受了外科剖腹手术治疗，以进行坏死组织清除、坏死病灶切除或胰腺切除。因酗酒或饮酒过量所致的急性坏死性胰腺炎以及腹腔镜手术不在本合同保障范围内。（四十四）非阿尔茨海默病所致严重痴呆指因阿尔茨海默病以外的脑的器质性疾病造成脑功能衰竭导致永久不可逆性的严重痴呆，临床表现为明显的认知能力障碍、行为异常和社交能力减退。被保险人自主生活能力完全丧失，无法独立完成六项基本日常生活活动中的三项或三项以上，日常生活必须持续受到他人监护。导致痴呆的疾病必须明确诊断，并且由完整的临床、实验室和影像学检查结果证实。神经官能症,精神疾病及酒精中毒所致脑损害不在保障范围内。（四十五）破裂脑动脉瘤夹闭手术指因脑动脉瘤破裂造成蛛网膜下腔出血，被保险人实际接受了在全麻下进行的开颅动脉瘤夹闭手术。脑动脉瘤（未破裂）预防性手术、颅骨打孔手术、动脉瘤栓塞手术、血管内手术及其他颅脑手术不在本保障范围内。（四十六）主动脉夹层血肿是指主动脉壁在受到某些病理因素的破坏后，高速、高压的主动脉血流将其内膜撕裂，以致主动脉腔内的血流通过主动脉内膜的破裂口进入主动脉内壁而形成血肿。被保险人需通过电脑断层扫描（CT）、磁共振扫描（MRI）、磁共振血管检验法（MRA）或血管扫描等检查，并且实施了胸腹切开的直视主动脉手术。（四十七）严重弥漫性系统性硬皮病一种系统性胶原血管病引起进行性的皮肤/血管和内脏器官的弥漫性纤维化。诊断必须明确并由活检和血清学证据支持并且疾病已经影响到心脏、肺或肾脏等内脏器官并且达到下列标准之一。（1）肺纤维化，已经出现肺动脉高压、肺心病；（2）心脏损害，心脏功能衰竭程度达到纽约心脏病学会的心功能分级标准之心功能IV级；（3）肾脏损害，已经出现肾功能衰竭。下列疾病除外：（1）局限硬皮病；（2）嗜酸细胞筋膜炎；（3）CREST综合征。（四十八）严重慢性复发性胰腺炎指慢性反复发作的胰腺炎症导致胰腺的广泛纤维化、坏死、弥漫性钙化及假性囊肿形成，造成胰腺功能障碍出现严重糖尿病和营养不良。必须满足以下所有条件：（1）CT显示胰腺广泛钙化或逆行胰胆管造影（ERCP）显示胰管扭曲、扩张和狭窄；（2）接受胰岛素替代治疗和酶替代治疗180天以上。酒精导致的慢性复发性胰腺炎不在本保障范围内。（四十九）终末期疾病被保险人被确诊为疾病的终末期状态。疾病已经无法以现有的医疗技术医治缓解，并且根据临床医学经验判断被保险人将于未来六个月内死亡。在家属及患者的要求和医师的同意下积极治疗已被放弃，所有治疗措施仅以减轻患者痛苦为目的。此疾病状态必须在被保险人生前已经确诊并且具有医疗证明文件和临床检查依据。（五十）肾髓质囊性病肾髓质囊性病，一种遗传性肾脏疾病，特点为肾髓质多发大小不等的囊肿并且伴有小管和间质性肾炎。患者表现为肾脏衰竭和肾小管功能障碍。肾髓质囊性病必须经肾组织活检确诊，并且有临床及影像学证据支持。其他的肾脏囊性病变不在保障范围内。（五十一）丝虫病所致象皮病指因丝虫感染导致淋巴阻塞性出现严重淋巴水肿，达到国际淋巴学会淋巴肿分期第III期，临床表现为肢体象皮肿，患肢较键肢增粗30以上，日常生活不能自理。(五十二)胰腺移植指因胰腺功能衰竭，已经实施了在全身麻醉下进行的胰腺的异体器官移植手术。单纯胰岛移植、部分胰腺组织或细胞的移植不在本保障范围之内。（五十三）严重心肌炎指被保险人因严重心肌炎性病变导致心功能损害造成持续的永久不可逆性的心功能衰竭。必须满足所有以下条件：（1）心功能衰竭程度达到纽约心脏病学会的心功能分级标准之心功能IV级，或左室射血分数低于30；（2）持续不间断180天以上；（3）被保险人永久不可逆性的体力活动能力受限，不能从事任何体力活动。（五十四）肺源性心脏病指被保险人因慢性肺部疾病导致慢性心功能损害造成永久不可逆性的心功能衰竭。心功能衰竭程度达到纽约心脏病学会的心功能分级标准之心功能IV级。被保险人永久不可逆性的体力活动能力受限，不能从事任何体力活动。（五十五）1型糖尿病1型糖尿病的特征为由于胰岛素分泌绝对不足引起严重胰岛素缺乏导致慢性血糖升高，需要依赖外源性胰岛素进行机体的葡萄糖代谢和维持生命。被保险人的1型糖尿病必须明确诊断，而且有血胰岛素测定及血C肽或尿C肽测定结果支持诊断，并且满足下列全部条件：（1）已经持续性地接受外源性胰岛素注射治疗连续180天以上；（2）因需要已经接受了下列治疗：因严重心律失常植入了心脏起搏器；或因坏疽自跖趾关节或以上切除了一趾或多趾。（五十六）肌营养不良症肌营养不良症是一组遗传性肌肉变性性病变，临床特征为与神经系统无关的肌肉无力和肌肉萎缩。须满足自主生活能力完全丧失，无法独立完成六项基本日常生活活动中的三项或三项以上。（五十七）嗜铬细胞瘤指发生在肾上腺或肾上腺外嗜铬组织的以分泌过多的儿茶酚胺为表现的神经内分泌肿瘤。嗜铬细胞瘤必须由内分泌专科医生诊断，并且满足以下所有条件：（1）临床有高血压症候群表现；（2）已经实施了嗜铬细胞瘤切除手术。（五十八）克雅氏病（CJD、人类疯牛病）CJD是一种传染性海绵状脑病，临床表现为快速进行性痴呆、肌阵挛和特征性脑电图变化。本病须经三级医院的专科医生根据WHO诊断标准明确诊断，并且被保险人自主生活能力完全丧失，无法独立完成六项基本日常生活活动中的三项或三项以上。CJD疑似病例除外。（五十九）严重川崎病川崎病为一种病因不明的系统性血管炎。本合同仅对诊断性检查证实川崎病并发冠状动脉瘤或其他心血管异常并且实际接受了手术治疗的情况予以理赔。（六十）完全性房室传导阻滞三度房室传导阻滞又称完全性房室传导阻滞是指心房的激动不能正常地传导到心室，造成心室率过于缓慢，出现心力衰竭和因大脑供血不足导致的晕厥、阿斯综合征。必须由专科医生明确诊断并且满足下列所有条件：（1）心电图表现为室性逸搏心律，心室率持续低于40次/分；（2）曾经有晕厥、阿斯综合征发作；（3）已经植入人工永久性心脏起搏器。（六十一）埃博拉病毒感染指埃博拉病毒感染导致的烈性传染病，并须满足下列全部条件：（1）实验室检查证实埃博拉病毒的存在；（2）从发病开始有超过30天的进行性感染症状。上述9.7的释义中部分术语释义如下：（一）肢体机能完全丧失肢体机能完全丧失是指肢体的三大关节中的两大关节僵硬，或不能随意识活动。肢体是指包括肩关节的整个上肢或包括髋关节的整个下肢。（二）语言能力或咀嚼吞咽能力完全丧失语言能力完全丧失是指无法发出四种语音（包括口唇音、齿舌音、口盖音和喉头音）中的任何三种、或声带全部切除，或因大脑语言中枢受伤害而患失语症。咀嚼吞咽能力完全丧失是指因牙齿以外的原因导致器质障碍或机能障碍，以致不能作咀嚼吞咽运动，除流质食物外不能摄取或吞咽的状态。（三）六项基本日常生活活动六项基本日常生活活动是指：（1）穿衣：自己能够穿衣及脱衣；（2）移动：自己从一个房间到另一个房间；（3）行动：自己上下床或上下轮椅；（4）如厕：自己控制进行大小便；（5）进食：自己从已准备好的碗或碟中取食物放入口中；（6）洗澡：自己进行淋浴或盆浴。（四）永久不可逆永久不可逆是指自疾病确诊或意外伤害发生之日起，经过积极治疗180天后，仍无法通过现有医疗手段恢复。（五）三大关节上肢三大关节是指肩、肘、腕关节，下肢三大关节是指髋、膝、踝关节。
9.8轻症疾病	本合同所指的轻症疾病（共23种），是指符合下列定义的疾病、疾病状态或手术：（一）非危及生命的（极早期的）恶性病变指经组织病理学检查被明确诊断为下列恶性病变，但未达到重大疾病恶性肿瘤的标准：（1）原位癌；（2）相当于Binet分期方案A期程度的慢性淋巴细胞白血病；（3）相当于AnnArbor分期方案I期程度的何杰金氏病；（4）皮肤癌（不包括恶性黑色素瘤及已发生转移的皮肤癌）（5）TNM分期为T1N0M0期或更轻分期的前列腺癌（如为女性被保险人，则不包括此项）。（二）不典型的急性心肌梗塞及冠状动脉成形手术指被保险人被确诊为以下定义的不典型急性心肌梗塞或（和）接受了冠状动脉成形手术。不典型急性心肌梗塞：指被临床诊断为急性心肌梗塞并接受了急性心肌梗塞治疗虽然未达到重大疾病急性心肌梗塞的给付标准，但满足下列全部条件：（1）肌钙蛋白有诊断意义的升高；（2）心电图有损伤性的ST段改变但未出现病理Q波。冠状动脉成形手术：指为了治疗明显的冠状动脉狭窄性疾病，首次实际实施了冠状动脉球囊扩张成形术、冠状动脉支架植入术、冠状动脉粥肿斑块切除术或激光冠状动脉成形术。（三）轻微脑中风指实际发生了脑血管的突发病变出现神经系统功能障碍表现，头颅断层扫描（CT）、核磁共振（MRI）等影像学检查证实存在对应病灶，确诊为脑出血、脑栓塞或脑梗塞，在确诊180天后虽然未达到重大疾病脑中风后遗症的给付标准但仍然遗留一肢或一肢以上肢体肌力III级或III级以下的运动功能障碍。（四）心脏瓣膜介入手术为了治疗心脏瓣膜疾病，实际实施了非开胸的经胸壁打孔内镜手术或经皮经导管介入手术进行的心脏瓣膜置换或修复手术。（五）视力严重受损指因疾病或意外伤害导致双目视力永久不可逆性丧失，虽然未达到重大疾病双目失明的给付标准，但满足下列条件之一：（1）双眼中较好眼矫正视力低于0.1（采用国际标准视力表，如果使用其他视力表应进行换算）；（2）双眼中较好眼视野半径小于20度。被保险人申请理赔时年龄必须在三周岁以上，并且提供理赔当时的视力丧失诊断及检查证据。（六）主动脉内手术为了治疗主动脉疾病实际实施了经皮经导管进行的动脉内手术。主动脉指胸主动脉和腹主动脉，不包括胸主动脉和腹主动脉的分支血管。（七）脑垂体瘤、脑囊肿、脑动脉瘤及脑血管瘤指经头颅断层扫描（CT）、核磁共振检查（MRI）或其他影像学检查被确诊为下列病变，并实际接受了手术或放射治疗。（1）脑垂体瘤；（2）脑囊肿；（3）脑动脉瘤、脑血管瘤。（八）较小面积III度烧伤（10）指烧伤程度为度，且度烧伤的面积大于全身体表面积的10但小于20。体表面积根据中国新九分法计算。（九）重症头部外伤指因头部遭受机械性外力伤害，引起脑重要部位损伤，并且由头颅断层扫描（CT）、核磁共振检查（MRI）或正电子发射断层扫描（PET）等影像学检查证实。头部外伤导致神经系统功能障碍，虽然未达到重大疾病严重脑损伤的给付标准，但是符合以下条件之一：（1）被保险人接受了全麻下颅骨切开颅内血肿清除术（颅骨钻孔术除外）；（2）在外伤180后仍然遗留一肢或一肢以上肢体肌力III级或III级以下的运动功能障碍。（十）单个肢体缺失指因疾病或意外伤害导致一个肢体自腕关节或踝关节近端（靠近躯干端）以上完全性断离，但未达到重大疾病多个肢体缺失的给付标准。（十一）急性坏死性胰腺炎指被保险人被确诊为急性坏死性胰腺炎，并实际接受了腹腔镜手术治疗，以进行坏死组织清除、坏死病灶切除或胰腺切除。因酗酒或饮酒过量所致的急性坏死性胰腺炎不在本合同保障范围内。（十二）严重脑炎或脑膜炎指因患脑炎或脑膜炎住院治疗，并且导致神经系统永久性的功能障碍。神经系统永久性的功能障碍，指疾病确诊180天后，虽然未达到重大疾病脑炎后遗症或脑膜炎后遗症的标准，仍遗留下列一种或一种以上障碍：（1）一肢或一肢以上肢体肌力III级或III级以下的运动功能障碍；（2）听力丧失，双耳平均听阈大于55分贝或一耳平均听阈大于90分贝；（3）视野缺损，双眼视野半径小于20度；（4）视力严重受损，双眼中较好眼矫正视力低于0.1（采用国际标准视力表，如果使用其他视力表应进行换算）。（十三）中度昏迷指因疾病或意外伤害处于昏迷的状态，对外界刺激或体内需求无反应，并需要使用插管和机械性呼吸的方法来维持生命至少48个小时。昏迷的诊断及有关证明必须由神经科专科医生确定，但未达到重大疾病深度昏迷的标准。因酗酒或药物滥用导致的昏迷不在保障范围内。（十四）中度重症肌无力指一种神经与肌肉接头部位传递障碍的自身免疫性疾病，临床特征是局部或全身横纹肌于活动时易于疲劳无力，颅神经眼外肌最易累及，也可涉及呼吸肌、下肢近端肌群以至全身肌肉。该病必须由专科医生明确诊断，且疾病确诊180天后，仍然存在自主生活能力部分丧失，无法独立完成六项基本日常生活活动中的二项，但未达到重大疾病全身性重症肌无力的标准。（十五）单耳失聪指因疾病或意外伤害导致单耳听力永久不可逆性丧失，在500赫兹、1000赫兹和2000赫兹语音频率下，平均听阈大于90分贝，且经纯音听力测试、声导抗检测或者听觉诱发电位检测等证实，但未达到重大疾病双耳失聪的标准。除内耳结构损伤等情形外，被保险人申请理赔时应提供理赔当时的听力丧失诊断及检查证据。（十六）单肾切除手术因肾脏疾病或外伤而确实已经接受手术完全切除左肾和/或右肾。手术必须被专科医生视为必要的。部分切除一个肾或因捐赠肾脏而所需的手术不在保障范围内。（十七）左肝叶或右肝叶切除术指因疾病或意外伤害导致必须以部分肝脏切除术切除最少一整叶左肝脏或一整叶右肝脏。诊断及治疗均须在医院内由专科医生认为是医疗必须的情况下进行。因酒精或者滥用药物引致的疾病或者紊乱及/或因捐赠肝脏而实施的肝脏手术均不在保障范围内。（十八）单肺切除手术指因疾病或意外伤害而确实已经接受手术完全切除了左全肺或右全肺。手术必须被专科医生视为必要的。部分切除一个肺或因捐赠肺脏而所需的手术不在保障范围内。（十九）中度系统性红斑狼疮本合同所指的系统性红斑狼疮必须符合下列所有理赔条件，但未达到重大疾病系统性红斑狼疮III型或III型以上狼疮性肾炎的标准：（1）在下列5项情况中出现最少2项：关节炎：非磨损性关节炎，需涉及两个或以上关节；浆膜炎：胸膜炎或心包炎；肾病：24小时尿蛋白定量达到0.5克，或尿液检查出现细胞管型；血液学异常：溶血性贫血、白细胞减少、或血小板减少；抗核抗体阳性、或抗dsDNA阳性，或抗Smith抗体阳性。（2）系统性红斑狼疮的诊断必须由风湿科或免疫系统专科医生确定。（二十）植入人工耳蜗手术指因疾病或意外伤害导致耳蜗或听觉神经永久性损坏，被保险人实际已经在医院内进行了医疗必须的人工耳蜗植入手术。（二十一）植入大脑内分流器为缓解已升高的脑脊液压力而确实已在脑室进行分流器植入手术。诊断及治疗均须在医院内由脑神经科专科医生认为是医疗必须的情况下进行。（二十二）胆总管小肠吻合术（胆道重建手术）因疾病或胆道损伤导致实际接受涉及胆总管小肠吻合术的胆道重建手术。诊断及治疗均须在医院内由专科医生认为是医疗必须的情况下进行。因胆道闭锁等先天性疾病而导致进行的胆道手术不在本项保障范围内。（二十三）意外受伤所需的面部重建手术因意外伤害导致面部受伤而确实进整形或者重建手术（颈部以上的面部构造完整、缺掉或者受损而对其形态及外观进修复或者重建），同时必须由专科医生证实该面部毁容所进的治疗是医疗所必须。因纯粹整容原因、独立的牙齿修复、独立的鼻骨折断或者独立的皮肤伤口所进行的手术均不在保障范围内。
9.9初次发生	指被保险人首次出现重大疾病或轻症疾病的前兆或异常的身体状况，包括与重大疾病或轻症疾病相关的症状及体征。
9.10医院	指国家卫生部医院等级分类中的二级或二级以上的公立医院，但不包括附属于前述医院或单独作为诊所、康复、护理、疗养、戒酒、戒毒等或相类似的医疗机构。同时该医院必须具有符合有关医院管理规定设置标准的医疗设备，并且全日二十四小时有合格医师及护士驻院提供医疗和护理等服务。
9.11专科医生	专科医生应当同时满足以下四项资格条件：（1）具有有效的中华人民共和国医师资格证书；（2）具有有效的中华人民共和国医师执业证书，并按期到相关部门登记注册；（3）具有有效的中华人民共和国主治医师或主治医师以上职称的医师职称证书；（4）在二级或二级以上医院的相应科室从事临床工作三年以上。
9.12酗酒	指没有节制地喝酒，以医疗机构或司法部门出具的酒精中毒或酒精摄入过量的相关证明为依据。
9.13毒品	指中华人民共和国刑法规定的鸦片、海洛因、甲基苯丙胺（冰毒）、吗啡、大麻、可卡因以及国家规定管制的其他能够使人形成瘾癖的麻醉药品和精神药品，但不包括由医生开具并遵医嘱使用的用于治疗疾病但含有毒品成分的处方药品。
9.14酒后驾驶	指经检测或鉴定，发生事故时车辆驾驶人员每百毫升血液中的酒精含量达到或超过一定的标准，公安机关交通管理部门依据道路交通安全法的规定认定为饮酒后驾驶或醉酒后驾驶。
9.15无合法有效驾驶证驾驶	指下列情形之一：（1）没有取得驾驶资格；（2）驾驶与驾驶证准驾车型不相符合的车辆；（3）持审验不合格的驾驶证驾驶；（4）持学习驾驶证学习驾车时，无教练员随车指导，或不按指定时间、路线学习驾车。
9.16无有效行驶证照	指下列情形之一：（1）发生保险事故时无公安机关交通管理部门核发的合法有效的行驶证、号牌，或临时号牌或临时移动号牌；（2）未依法按时进行或通过机动车安全技术检验。
9.17机动车	指以动力装置驱动或者牵引，上道路行驶的供人员乘用或者用于运送物品以及进行工程专项作业的轮式车辆。
9.18感染艾滋病病毒或患艾滋病	艾滋病病毒指人类免疫缺陷病毒，英文缩写为HIV。艾滋病指人类免疫缺陷病毒引起的获得性免疫缺陷综合症，英文缩写为AIDS。在人体血液或其它样本中检测到艾滋病病毒或其抗体呈阳性，没有出现临床症状或体征的，为感染艾滋病病毒；如果同时出现了明显临床症状或体征的，为患艾滋病。
9.19遗传性疾病	指生殖细胞或受精卵的遗传物质（染色体和基因）发生突变（或畸变）所引起的疾病，通常具有由亲代传至后代的垂直传递的特征。
9.20先天性畸形、变形或染色体异常	指被保险人出生时就具有的畸形、变形或染色体异常。先天性畸形、变形和染色体异常依照世界卫生组织疾病和有关健康问题的国际统计分类（ICD10）确定。
9.21现金价值	指本合同所具有的价值，通常体现为解除合同时，根据精算原理计算的，由我们退还的那部分金额。
9.22医疗机构	指按照中华人民共和国卫生部所颁布的分类标准划分的任何二级及以上公立医院。医疗机构还包括香港、澳门、台湾地区医院和国外医院，该医院应该是一种合法成立并按照当地法律营运的机构，其主要业务是在居民住院的基础上接收、护理和治疗病人或伤员，并且拥有诊断和内外科设施，同时还能全天二十四小时有合格医师及护士驻院提供医疗及护理服务。医疗机构不包括主要作为诊所、康复、护理、休养、静养、戒酒、戒毒等或类似的医疗机构。
9.23现金价值净额	是现金价值扣除欠交的保险费、保单贷款和自动垫交保险费及这些款项应付利息后的余额。
9.24本条款约定利率	垫交保险费、保单贷款均按本约定利率计算，我们于每月第一个营业日根据监管规定和市场情况确定该利率。
