question	answer
1.1合同构成	本合同是您与我们约定保险权利义务关系的协议，包括本保险条款、保险单或其他保险凭证、投保单、与保险合同有关的投保文件、合法有效的声明、健康告知书、变更申请书、批注、批单及其他您与我们共同认可的书面协议。
1.2合同成立与生效	一、您提出保险申请、我们同意承保，本合同成立。二、除另有约定外，自本合同成立、本公司收取保险费并签发保险单后次日零时起本合同生效，生效日应载于保险单上。本公司自生效日的零时起开始承担本合同约定的保险责任。三、保单年度．．．．(见10.1)、保单周年日．．．．．(见10.2)、保险费应交日．．．．．．（见10.3）均以生效日进行计算。
1.3投保年龄	指投保时被保险人的年龄，投保年龄以周岁．．(见10.4)计算。
1.4犹豫期	一、您收到本合同并书面签收或按照本公司要求的其他方式对本合同进行确认之日起，有10日的犹豫期（通过商业银行投保的，犹豫期为15日）。在此期间请您仔细审阅本合同的各项内容，特别是责任免除条款、合同解除条款以及如实告知条款等内容。若您认为本合同与您的需求不相符，您可以在此期间提出解除本合同，我们将在扣除不超过10元的工本费后无息退还您所交纳的保险费。但经本公司体检的，本公司有权扣除体检费。二、您在犹豫期内提出解除合同时需填写解除合同申请书，并提供保险合同及您的有效身份证件．．．．．．(见10.5)。自我们收到解除合同申请书时起，本合同效力终止，我们自本合同生效日起不承担保险责任。
我们提供的保障	
2.1等待期	从本合同生效或最后复效之日起180天内（包括第180天），被保险人因疾病导致下列情形之一的：(1)身故；(2)首次患本合．．．．．同约定的重大疾病．．．．．．．．（见10.6；10.7）；(3)首次．．患本合同．．．．约定．．的轻症疾病．．．．．（见10.8；10.9）。本公司不承担保险责任，本公司向您无息返还已交保险费，本合同效力终止。这180天时间被称为等待期。因意外伤害．．．．（见10.10）发生上述情形之一的，无等待期。
2.2保险责任	在本合同有效期间内，我们按照以下约定承担保险责任：们将按累计已交纳的保险费给付身故保险金，本合同效力终止。若被保险人因意外伤害或于等待期后因疾病导致身故，且身故时年满十八周岁，我们将按本合同的基本保险金额给付身故保险金，本合同效力终止。
二、重大疾病保险金	本合同约定的重大疾病分为A、B、C、D四组，详细疾病分组信息请见重大疾病分．．．．组．（见10.11）。每组重大疾病保险金的给付次数以一次为限，给付后该组重大疾病的保险责任终止。本合同重大疾病保险金的累计给付次数以三次为限，当累计给付达到三次时，本合同效力终止。
（一）首次重大疾病保险金	若被保险人因意外伤害或于等待期后首次发病．．（见10.12）并经专科医生．．．．（见10.13）确诊首次患有本合同约定的重大疾病，我们将按本合同的基本保险金额给付首次重大疾病保险金（若被保险人同时符合一项以上重大疾病时，该给付以一次为限），给付后该重大疾病所属组别的保险责任终止。若我们已按照上述约定给付首次重大疾病保险金，则本合同的现金价值．．．．（见10.14）自首次重大疾病确诊之日起降低为零，同时，第一条身故保险金的保险责任与第三条轻症疾病保险金的保险责任均终止，我们仅继续承担重大疾病保险金的保险责任。
（二）第二次重大疾病保险金	在我们已按本合同的约定给付首次重大疾病保险金的情况下，若被保险人自首次重大疾病确诊之日起满180天后，经专科医生确诊首次患有本合同约定的除首次重大疾病所属组别以外其他组别中的任何一种重大疾病，我们将按本合同的基本保险金额给付第二次重大疾病保险金（若被保险人同时符合一项以上重大疾病时，该给付以一次为限），给付后该重大疾病所属组别的保险责任终止。
（三）第三次重大疾病保险金	在我们已按本合同的约定给付首次重大疾病保险金和第二次重大疾病保险金的情况下，若被保险人自第二次重大疾病确诊之日起满180天后，经专科医生确诊首次患有本合同约定的除首次重大疾病所属组别和第二次重大疾病所属组别以外其他组别中的任何一种重大疾病，我们将按本合同的基本保险金额向被保险人给付第三次重大疾病保险金（若被保险人同时符合一项以上重大疾病时，该给付以一次为限），本合同效力终止。
三、轻症疾病保险金	本合同约定的轻症疾病分为A、B、C、D四组，详细疾病分组信息请见轻症疾病分组（见10.15）。每组轻症疾病保险金的给付次数以一次为限，给付后该组轻症疾病的保险责任终止。本合同轻症疾病保险金的累计给付次数以两次为限，当累计给付达到两次时，本项保险责任终止。若被保险人同时符合本合同约定的重大疾病定义和轻症疾病定义的，我们仅承担给付重大疾病保险金的保险责任。
（一）首次轻症疾病保险金	若被保险人因意外伤害或于等待期后首次发病并经专科医生确诊首次患有本合同约定的轻症疾病，我们将按本合同基本保险金额的30给付轻症疾病保险金（若被保险人同时符合一项以上轻症疾病时，该给付以一次为限），给付后该轻症疾病所属组别的保险责任终止。
（二）第二次轻症疾病保险金	在我们已按本合同的约定给付首次轻症疾病保险金的情况下，若被保险人自首次轻症疾病确诊之日起满180天后，经专科医生确诊首次患有本合同约定的除首次轻症疾病所属组别以外其它组别中的任何一种轻症疾病，我们将按本合同基本保险金额的30给付第二次轻症疾病保险金（若被保险人同时符合一项以上轻症疾病时，该给付以一次为限），轻症疾病保险金的保险责任终止。
四、重大疾病或轻症疾病豁免保险费	若被保险人符合上述第二条（一）首次重大疾病保险金或第三条（一）首次轻症疾病保险金的给付条件，则我们自被保险人经专科医生确诊首次患有本合同约定的重大疾病或轻症疾病的下一个保险费应交日开始，豁免本合同应交纳的各期保险费至交费期限届满为止。被豁免的保险费视为已交纳，同时本合同继续有效。在豁免保险费期间，我们不接受本合同基本保险金额以及交费方式的变更。
2.3责任免除	一、因下列情形之一导致被保险人患本合同约定的重大疾病或轻症疾病的，我们不承担给付重大疾病保险金、轻症疾病保险金及重大疾病或轻症疾病豁免保险费的责任：(一)投保人对被保险人的故意杀害、故意伤害；(二)被保险人故意自伤，但自伤时为无民事行为能力人的除外；(三)被保险人故意犯罪或抗拒依法采取的刑事强制措施；(四)被保险人主动吸食或注射毒品．．（见10.16）；(五)被保险人酒后驾驶．．．．（见10.17）、无有效驾驶证驾驶．．．．．．．．（见10.18）或驾驶无有效行驶证．．．．．．（见10.19）的机动．．车．（见10.20）；(六)战争、军事冲突、暴乱、恐怖活动或武装叛乱（以上行为以政府宣告或认定为准）；(七)核爆炸、核辐射或核污染；(八)被保险人感染艾滋病病毒．．．．．（见10.21）或患艾滋病．．．（见10.22）；(九)遗传性疾病．．．．．（见10.23）、先天性畸形．．．．．、变形或染色体异常．．．．．．．．（见10.24）。二、因下列情形之一，导致被保险人身故的，我们不承担给付身故保险金的责任：(一)投保人对被保险人的故意杀害、故意伤害；(二)被保险人故意犯罪或抗拒依法采取的刑事强制措施；(三)自本合同成立或合同效力恢复之日起二年内自杀，但自杀时为无民事行为能力人的除外；(四)被保险人故意自伤；(五)被保险人主动吸食或注射毒品；(六)被保险人酒后驾驶、无有效驾驶证驾驶或驾驶无有效行驶证的机动车；(七)战争、军事冲突、暴乱、恐怖活动或武装叛乱（以上行为以政府宣告或认定为准）；(八)核爆炸、核辐射或核污染；(九)遗传性疾病、先天性畸形、变形或染色体异常。发生上述第二节第（一）项情形导致被保险人身故的，本合同效力终止，我们向其他权利人退还本合同当时的现金价值，其他权利人按照被保险人第一顺序法定继承人、第二顺序法定继承人的顺序确定。因上述第二节第（二）至（九）项情形被保险人身故的，本合同效力终止，我们向您退还本合同的现金价值。
2.4未成年人身故保险金限制	为未成年人投保的人身保险，因被保险人身故给付的保险金总和不得超过国务院保险监督管理机构规定的限额。对身故给付保险金额总和的约定也不得超过前述限额。
2.5基本保险金额	本合同的基本保险金额由您在投保时与我们约定，并在保险单中载明。投保时的基本保险金额须符合我们当时的投保规则。
2.6保险期间	本合同的保险期间自本合同生效日的零时起至被保险人终身。
保险金的申请	
3.1受益人	一、您或被保险人可以指定一人或多人为保险金受益人。保险金受益人为多人时，可以确定受益顺序和受益份额；未确定受益顺序和受益份额的，各受益人按照相同顺序和相等份额享有受益权。二、被保险人为无民事行为能力人或者限制民事行为能力人的，可以由其监护人指定受益人。三、您或被保险人可以变更受益人并书面通知我们。我们收到变更受益人的书面通知后，在保险合同上批注或附贴批单。四、您在指定和变更受益人时，必须经被保险人同意。五、被保险人身故后，遇有下列情形之一的，保险金作为被保险人的遗产，由我们依照中华人民共和国继承法的规定履行给付保险金的义务：(一)没有指定受益人的；(二)受益人指定不明无法确定的；(三)受益人先于被保险人身故，没有其他受益人的；(四)受益人依法丧失受益权或放弃受益权，没有其他受益人的。六、受益人与被保险人在同一事件中身故，且无法确定身故先后顺序的，推定受益人先于被保险人身故。七、受益人故意造成被保险人身故、伤残、疾病的，或故意杀害被保险人未遂的，该受益人丧失受益权。八、除另有约定外，轻症疾病保险金、重大疾病保险金受益人约定为被保险人本人。
3.2保险事故通知	您、被保险人或受益人应于知道保险事故发生之日起10日内通知我们。若故意或者因重大过失未及时通知，致使保险事故的性质、原因、损失程度等难以确定的，我们对无法确定的部分，不承担给付保险金的责任，但我们通过其他途径已经及时知道或应当及时知道保险事故发生或虽未及时通知但不影响我们确定保险事故的性质、原因、损失程度的除外。
3.3保险金申请	在申请保险金时，请按照下列方式办理：
重大疾病保险金、轻症疾病保险金申请	由受益人或被保险人作为申请人填写保险金给付申请书，并向我们提供下列资料：一、申请人的有效身份证件；二、国家卫生行政部门认定的医疗机构．．．．（见10.25）出具的可证明被保险人患重大疾病或轻症疾病的诊断证明和诊断所患重大疾病或轻症疾病必需的检查报告；三、所能提供的与确认保险事故的性质、原因、伤害程度等有关的其他资料。我们提供下列资料：一、申请人的有效身份证件；二、国家卫生行政部门认定的医疗机构、公安部门或其他相关机构出具的被保险人死亡证明；三、被保险人的户籍注销证明；四、所能提供的与确认保险事故的性质、原因等有关的其他资料。
特别注意事项	一、委托他人领取保险金时，受托人还必须提供本人的有效身份证件及委托人亲笔签名的授权委托书。二、保险金作为被保险人遗产时，继承人还必须提供可证明其合法继承权的相关权利文件。三、受益人、被保险人或者继承人为无民事行为能力人或者限制民事行为能力人时，由其合法监护人代其申请领取保险金，其合法监护人还必须提供受益人或者继承人为无民事行为能力人或者限制民事行为能力人的证明和监护人具有合法监护权的证明。四、上述申请资料不完整的，我们将及时一次性通知申请人补充提供有关资料。
3.4宣告死亡处理	一、若被保险人在本合同有效期间内被人民法院宣告死亡，保险金申请人在申请身故保险金时还须提供人民法院出具的具有最终法律效力的宣告死亡证明文件。二、被保险人在本合同有效期间内被人民法院宣告死亡的，我们将以人民法院出具的具有最终法律效力的宣告死亡证明文件所确定的死亡日期为被保险人身故日。三、若被保险人在人民法院宣告死亡之后重新出现或确知其没有死亡，保险金申请人应于知道或应当知道被保险人生还消息之日起30日内将已领取的身故保险金一次性返还给我们，本合同的效力由您和我们双方依法协商处理。
3.5保险金给付	一、我们在收到保险金给付申请书及本合同约定的资料后，将在5日内作出核定；情形复杂的，在30日内作出核定。对属于保险责任的，我们在与受益人达成给付保险金的协议后10日内，履行给付保险金义务。二、我们未及时履行前款规定义务的，除支付保险金外，应当赔偿受益人因此受到的损失。三、对不属于保险责任的，我们自作出核定之日起3日内向受益人发出拒绝给付保险金通知书并说明理由。四、我们在收到保险金给付申请书及本合同约定的资料之日起60日内，对给付保险金的数额不能确定的，根据已有资料可以确定的数额先予支付；我们最终确定给付保险金的数额后，再给付相应的差额。
3.6诉讼时效	申请人向我们请求给付身故保险金的诉讼时效期间为五年，除身故保险金外其他保险金，申请人向我们请求给付保险金的诉讼时效期间为两年，自其知道或者应当知道保险事故发生之日起计算。
保险费的交纳	
4.1保险费交纳	一、本合同的保险费交费方式和交费期间由您和本公司约定并在保险单上载明。二、在交纳首期保险费后，您应当在每个保险费应交日交纳当期的保险费。
4.2宽限期	一、如果您在保险费应交日未交纳保险费，自保险费应交日的次日起60日内为宽限期。宽限期内发生的保险事故，本公司仍会承担保险责任，但在给付保险金时会扣除您欠交的保险费。二、如果宽限期结束之后您仍未交纳保险费，则本合同自宽限期满的次日零时起中止，但本合同另有约定的除外。
现金价值权益	
5.1现金价值	本合同保单年度末的现金价值在保险单上载明。
5.2保单贷款	一、在本合同有效期内，经书面或按照本公司要求的其他方式申请且我们审核同意后，您可向我们办理保单贷款。申请贷款时累计贷款金额本金和利息．．（见10.26）最高不得超过本合同当时现金价值的80，每次贷款期限最长不超过180天。贷款利率按您与我们签订的贷款协议中约定的利率执行。二、贷款本息在贷款到期时一并归还。若您到期未能足额偿还贷款本息，则您所欠的贷款本金及利息将作为新的贷款本金计息。三、当未还贷款本金及利息加上其他各项欠款超过保险合同现金价值时，本合同中止。四、您申请保单贷款须提交保单贷款申请，并凭保险合同原件、您的有效身份证件办理。
5.3保险费自动垫交	一、您可以选择保险费自动垫交功能，若您选择了保险费自动垫交，且您在宽限期结束时仍未交纳应交保险费的，我们将以本合同及附加合同的现金价值扣除您尚未偿还的各项欠款之后的余额，自动垫交本合同及附加合同的应交保险费，本合同及附加合同继续有效。我们将对保险费自动垫交的部分收取利息，具体的利息计算方式同保单贷款。二、当现金价值扣除各项欠款后的余额不足以垫交一期本合同及附加合同保险费时，本合同及附加合同效力中止。
6.1合同效力中止	在本合同效力中止期间，本公司不承担保险责任。
6.2合同效力恢复	一、本合同效力中止后2年内，您可以申请恢复合同效力（简称复效）。您应填写复效申请书，我们会要求您提供被保险人的健康声明书、体检报告书及其他相关证明文件，我们会对材料进行审核，做出是否同意复效的决定。二、经双方达成复效协议，自您补交本合同保险费及其他各项欠款的次日零时起，本合同效力恢复。三、自本合同效力中止之日起满2年您和我们未达成复效协议的，我们有权解除本合同。我们解除本合同的，我们向您退还合同效力中止时本合同的现金价值。
合同解除	
7.1您解除合同的手续及风险	一、若您在犹豫期后申请解除本合同，请填写解除合同申请书并向我们提供下列资料：（一）本合同；（二）您的有效身份证件。二、若经办人为代理人，则应另提供授权委托书、代理人有效身份证件等证明文件。三、自我们收到解除合同申请书时起，本合同效力终止。我们自收到解除合同申请书之日起30日内退还本合同的现金价值。四、您在犹豫期后解除合同可能会遭受一定损失。
7.2合同内容变更	本合同生效后，若您需变更本合同的内容，应当向我们提出变更合同的申请，在您与我们达成一致后，可以对合同约定事项进行变更。变更本合同的，应当由我们在保险单或者其他保险凭证上批注或者附贴批单，或者由您与我们订立书面的变更协议。
7.3联系方式变更	为保障您的合法权益，您的住所、通讯地址或电话等联系方式变更时，请及时以书面形式或双方认可的其他形式通知我们。若您未以书面形式或双方认可的其他形式通知我们，我们按本合同载明的最后住所或通讯地址发送的有关通知，均视为已送达给您。
8.1明确说明	一、订立本合同时，我们会向您说明本合同的内容。二、对保险条款中免除我们责任的条款，我们在订立合同时应当在投保单、保险单或其他保险凭证上作出足以引起您注意的提示，并对该条款的内容以书面或口头形式向您作出明确说明，未作提示或明确说明的，该条款不产生效力。
8.2如实告知	一、我们就您和被保险人的有关情况提出询问的，您应当如实告知。二、若您故意或因重大过失未履行前款规定的如实告知义务，足以影响我们决定是否同意承保或提高保险费率的，我们有权解除本合同。三、若您故意不履行如实告知义务，对于本合同解除前发生的保险事故，我们不承担给付保险金的责任，并不退还保险费。四、若您因重大过失未履行如实告知义务，对保险事故的发生有严重影响的，对于本合同解除前发生的保险事故，我们不承担给付保险金的责任，但应当退还保险费。五、我们在本合同订立时已经知道您未如实告知的情况的，我们不得解除本合同；发生保险事故的，我们承担给付保险金的责任。
8.3本公司合同解除权的限制	前款规定的合同解除权，自我们知道有解除事由之日起，超过30日不行使而消灭。自本合同成立之日起超过2年的，我们不得解除合同；发生保险事故的，我们承担给付保险金的责任。
9.1年龄性别错误	您在申请投保时，应将与有效身份证件相符的被保险人的出生日期和性别在投保单上填明，如果发生错误按照下列方式办理：一、您申报的被保险人年龄不真实，并且其真实年龄不符合本合同约定投保年龄限制的，本公司有权解除合同。本公司行使合同解除权适用本公司合同解除权的限制的规定。对于解除合同的，本公司向您退还本合同当时的现金价值。二、您申报的被保险人年龄、性别不真实，致使您实付保险费少于应付保险费的，本公司有权更正并要求您补交保险费。若已经发生保险事故，在给付保险金时按实付保险费和应付保险费的比例给付。三、您申报的被保险人年龄、性别不真实，致使您实付保险费多于应付保险费的，本公司会将多收的保险费退还给您。
9.2合同效力终止	当发生下列情形之一时，本合同效力终止：一、您申请解除本合同；二、因本合同其他条款所列情况而效力终止。
9.3未还款项	我们在给付各项保险金、退还现金价值或者返还保险费时，如果您有欠交的保险费、保单贷款或者其他各项欠款，我们按照您和其他权利人与我们的约定，在扣除上述各项欠款及应付利息后给付。
9.4争议处理	在本合同履行过程中发生任何争议，当事人应根据本合同约定选择下列两种方式之一予以解决：一、因履行本合同发生的争议，由当事人协商解决，协商不成的，提交双方共同选定的仲裁委员会，按其当时有效的仲裁规则仲裁解决。二、因履行本合同发生的争议，由当事人协商解决，协商不成的，依法向人民法院起诉。
释义	
10.1保单年度	从本合同生效日或保单周年日零时起至下一年度的保单周年日零时止为一个保单年度。
10.2保单周年日	指本合同生效日在合同生效后每年的对应日，不含本合同生效日当日。若当月没有对应的同一日，则以该月最后一日为对应日。
10.3保险费应交日	指本合同保险费交费期间内本合同生效日在每月、每季、每半年或者每年（根据交费方式确定）的对应日的前一日。如果当月无对应的同一日，则以该月最后一日为对应日。
10.4周岁	指按法定身份证明文件中记载的出生日期计算的年龄，自出生之日起为零周岁，每经过一年增加一岁，不足一年的不计。
10.5有效身份证件	指由政府主管部门规定的证明其身份的证件，如：居民身份证、按规定可使用的有效护照、军官证、警官证、士兵证、户口簿等证件。
10.6首次患本合同约定的重大疾病	指被保险人患同时符合以下条件的重大疾病：(一)被保险人自出生后首次出现该重大疾病之症状体征；(二)被保险人在本合同有效期间内首次出现该重大疾病之症状体征并被确诊患该重大疾病；(三)该重大疾病之症状体征符合本合同的定义；(四)该重大疾病已在本合同中列明。对于被保险人在本合同生效日前出现的本合同所列的重大疾病，本公司不承担给付保险金责任。
10.7重大疾病	指被保险人发生符合以下疾病定义所述条件的疾病（共105种），应当由专科医生明确诊断。第1至第25项为中国保险行业协会与中国医师协会共同制定的重大疾病保险的疾病定义，第26至第105项为本公司增加的疾病种类并自行制定的疾病定义。
1、恶性肿瘤	指恶性细胞不受控制的进行性增长和扩散，浸润和破坏周围正常组织，可以经血管、淋巴管和体腔扩散转移到身体其它部位的疾病。经病理学检查结果明确诊断，临床诊断属于世界卫生组织疾病和有关健康问题的国际统计分类（ICD10）的恶性肿瘤范畴。下列疾病不在保障范围内：原位癌．．．（见注1）；相当于Binet分期方案A期程度的慢性淋巴细胞白血病；相当于AnnArbor分期方案I期程度的何杰金氏病；皮肤癌（不包括恶性黑色素瘤及已发生转移的皮肤癌）；TNM分期为T1N0M0期或更轻分期的前列腺癌；感染艾滋病病毒或患艾滋病期间所患恶性肿瘤。注1：指恶性细胞局限于上皮内尚未穿破基底膜浸润周围正常组织的癌细胞新生物。原位癌必须经对固定活组织的组织病理学检查明确诊断。被保险人必须已经接受了针对原位癌病灶的积极治疗，所谓的积极治疗包含手术、化疗或放疗等治疗方式。
2、急性心肌梗塞	指因冠状动脉阻塞导致的相应区域供血不足造成部分心肌坏死。须满足下列至少三项条件：典型临床表现，例如急性胸痛等；新近的心电图改变提示急性心肌梗塞；心肌酶或肌钙蛋白有诊断意义的升高，或呈符合急性心肌梗塞的动态性变化；发病90天后，经检查证实左心室功能降低，如左心室射血分数低于50。
3、脑中风后遗症	指因脑血管的突发病变引起脑血管出血、栓塞或梗塞，并导致神经系统永久性的功能障碍。神经系统永久性的功能障碍，指疾病确诊180天后，仍遗留下列一种或一种以上障碍：一肢或一肢以上肢体机能完全丧失．．．．．．．．（见注2）；语言能力或咀嚼吞咽能力完全．．．．．．．．．．．．．丧失．．（见注3）；自主生活能力完全丧失，无法独立完成六项基本日常生活活动．．．．．．．．．．（见注4）中的三项或三项以上。注2：指肢体的三大关节中的两大关节僵硬，或不能随意识活动。肢体是指包括肩关节的整个上肢或包括髋关节的整个下肢。注3：语言能力完全丧失，指无法发出四种语音（包括口唇音、齿舌音、口盖音和喉头音）中的任何三种、或声带全部切除，或因大脑语言中枢受伤害而患失语症。咀嚼吞咽能力完全丧失，指因牙齿以外的原因导致器质障碍或机能障碍，以致不能作咀嚼吞咽运动，除流质食物外不能摄取或吞咽的状态。注4：六项基本日常生活活动是指：穿衣：自己能够穿衣及脱衣；移动：自己从一个房间到另一个房间；行动：自己上下床或上下轮椅；如厕：自己控制进行大小便；进食：自己从已准备好的碗或碟中取食物放入口中；洗澡：自己进行淋浴或盆浴。
4、重大器官移植术或造血干细胞移植术	重大器官移植术，指因相应器官功能衰竭，已经实施了肾脏、肝脏、心脏或肺脏的异体移植手术。造血干细胞移植术，指因造血功能损害或造血系统恶性肿瘤，已经实施了造血干细胞（包括骨髓造血干细胞、外周血造血干细胞和脐血造血干细胞）的异体移植手术。
5、冠状动脉搭桥术（或称冠状动脉旁路移植术）	指为治疗严重的冠心病，实际实施了开胸进行的冠状动脉血管旁路移植的手术。冠状动脉支架植入术、心导管球囊扩张术、激光射频技术及其它非开胸的介入手术、腔镜手术不在保障范围内。
6、终末期肾病（或称慢性肾功能衰竭尿毒症期）	指双肾功能慢性不可逆性衰竭，达到尿毒症期，经诊断后已经进行了至少90天的规律性透析治疗或实施了肾脏移植手术。若本项疾病已经赔付，那么后续因本项疾病导致的重大疾病所属组别A组中的重大器官移植术或造血干细胞移植术将不再进行赔付。
7、多个肢体缺失	指因疾病或意外伤害导致两个或两个以上肢体自腕关节或踝关节近端（靠近躯干端）以上完全性断离。
8、急性或亚急性重症肝炎	指因肝炎病毒感染引起肝脏组织弥漫性坏死，导致急性肝功能衰竭，且经血清学或病毒学检查证实，并须满足下列全部条件：重度黄疸或黄疸迅速加重；肝性脑病；B超或其它影像学检查显示肝脏体积急速萎缩；肝功能指标进行性恶化。
9、良性脑肿瘤	指脑的良性肿瘤，已经引起颅内压增高，临床表现为视神经乳头水肿、精神症状、癫痫及运动感觉障碍等，并危及生命。须由头颅断层扫描（CT）、核磁共振检查（MRI）或正电子发射断层扫描（PET）等影像学检查证实，并须满足下列至少一项条件：实际实施了开颅进行的脑肿瘤完全切除或部分切除的手术；实际实施了对脑肿瘤进行的放射治疗。脑垂体瘤、脑囊肿、脑血管性疾病不在保障范围内。
竭失代偿期	持续性黄疸；腹水；肝性脑病；充血性脾肿大伴脾功能亢进或食管胃底静脉曲张。因酗酒．．（见注5）或药物滥用导致的肝功能衰竭不在保障范围内。注5：是指酒精摄入过量。长期过量饮酒导致身体脏器严重损害，或一次大量饮酒导致急性酒精中毒或自制力丧失造成自身伤害、斗殴肇事或交通肇事。酒精过量由医疗机构或公安部门判定。
11、脑炎后遗症或脑膜炎后遗症	指因患脑炎或脑膜炎导致的神经系统永久性的功能障碍。神经系统永久性的功能障碍，指疾病确诊180天后，仍遗留下列一种或一种以上障碍：一肢或一肢以上肢体机能完全丧失；语言能力或咀嚼吞咽能力完全丧失；自主生活能力完全丧失，无法独立完成六项基本日常生活活动中的三项或三项以上。
12、深度昏迷	指因疾病或意外伤害导致意识丧失，对外界刺激和体内需求均无反应，昏迷程度按照格拉斯哥昏迷分级（Glasgowcomascale）结果为5分或5分以下，且已经持续使用呼吸机及其它生命维持系统96小时以上。因酗酒或药物滥用导致的深度昏迷不在保障范围内。
13、双耳失聪	指因疾病或意外伤害导致双耳听力永久不可逆．．．．．（见注6）性丧失，在500赫兹、1000赫兹和2000赫兹语音频率下，平均听阈大于90分贝，且经纯音听力测试、声导抗检测或听觉诱发电位检测等证实。被保险人申请理赔时年龄必须在3周岁以上，并且提供理赔当时的听力丧失诊断及检查证据。注6：指因疾病确诊或意外发生之日起，经过积极治疗180天后，仍无法通过现有医疗手段恢复。
14、双目失明	指因疾病或意外伤害导致双眼视力永久不可逆性丧失，双眼中较好眼须满足下列至少一项条件：眼球缺失或摘除；矫正视力低于0.02（采用国际标准视力表，如果使用其它视力表应进行换算）；视野半径小于5度。被保险人申请理赔时年龄必须在3周岁以上（眼球缺失或摘除的不受此限），并且提供理赔当时的视力丧失诊断及检查证据。
15、瘫痪	指因疾病或意外伤害导致两肢或两肢以上肢体机能永久完全丧失。肢体机能永久完全丧失，指疾病确诊180天后或意外伤害发生180天后，每肢三大关节中的两大关节仍然完全僵硬，或不能随意识活动。
17、严重阿尔茨海默症	指因大脑进行性、不可逆性改变导致智能严重衰退或丧失，临床表现为明显的认知能力障碍、行为异常和社交能力减退，其日常生活必须持续受到他人监护。须由头颅断层扫描（CT）、核磁共振检查（MRI）或正电子发射断层扫描（PET）等影像学检查证实，且自主生活能力完全丧失，无法独立完成六项基本日常生活活动中的三项或三项以上。神经官能症和精神疾病不在保障范围内。
18、严重脑损伤	指因头部遭受机械性外力，引起脑重要部位损伤，导致神经系统永久性的功能障碍。须由头颅断层扫描（CT）、核磁共振检查（MRI）或正电子发射断层扫描（PET）等影像学检查证实。神经系统永久性的功能障碍，指脑损伤180天后，仍遗留下列一种或一种以上障碍：一肢或一肢以上肢体机能完全丧失；语言能力或咀嚼吞咽能力完全丧失；自主生活能力完全丧失，无法独立完成六项基本日常生活活动中的三项或三项以上。列全部条件：药物治疗无法控制病情；自主生活能力完全丧失，无法独立完成六项基本日常生活活动中的三项或三项以上。继发性帕金森综合征不在保障范围内。面积根据中国新九分法计算。
21、严重原发性肺动脉高压	指不明原因的肺动脉压力持续性增高，进行性发展而导致的慢性疾病，已经造成永久不可逆性的体力活动能力受限，达到美国纽约心脏病学会心功能状态分级IV级，且静息状态下肺动脉平均压超过30mmHg。
22、严重运动神经元病	是一组中枢神经系统运动神经元的进行性变性疾病，包括进行性脊肌萎缩症、进行性延髓麻痹症、原发性侧索硬化症、肌萎缩性侧索硬化症。须满足自主生活能力完全丧失，无法独立完成六项基本日常生活活动中的三项或三项以上的条件。全切除不受此时间限制），仍无法通过现有医疗手段恢复。精神心理因素所致的语言能力丧失不在保障范围内。被保险人申请理赔时年龄必须在3周岁以上，并且提供理赔当时的语言能力丧失诊断及检查证据。精神心理因素所致的语言能力丧失不在保障范围内。
24、重型再生障碍性贫血	指因骨髓造血功能慢性持续性衰竭导致的贫血、中性粒细胞减少及血小板减少。须满足下列全部条件：骨髓穿刺检查或骨髓活检结果支持诊断；外周血象须具备以下三项条件：中性粒细胞绝对值0.510/L；网织红细胞1；血小板绝对值2010/L。
25、主动脉手术	指为治疗主动脉疾病，实际实施了开胸或开腹进行的切除、置换、修补病损主动脉血管的手术。主动脉指胸主动脉和腹主动脉，不包括胸主动脉和腹主动脉的分支血管。动脉内血管成形术不在保障范围内。
26、慢性呼吸功能衰竭	慢性肺部疾病导致永久不可逆性的慢性呼吸功能衰竭。慢性呼吸功能衰竭必须明确诊断并满足下列全部条件：动脉血氧分压（PaO）50mmHg；动脉血氧饱和度（SaO）80；因缺氧必须接受持续的输氧治疗。理赔时必须提供以上三项相应的证明文件或检查报告。
27、严重溃疡性结肠炎	指伴有致命性电解质紊乱的急性暴发性溃疡性结肠炎，病变累及全结肠，表现为严重的血便和系统性症状体征，溃疡性结肠炎必须根据组织病理学特点诊断，并且被保险人已经接受了结肠切除和回肠造瘘术。
28、严重哮喘	指一种反复发作的严重支气管阻塞性疾病，须符合下列全部标准：过去两年中曾因哮喘持续状态住院治疗，并提供完整住院记录；身体活动耐受能力显著且持续下降；因慢性过度换气导致胸廓畸形；在家中需要医生处方的氧气治疗法；持续日常服用口服类固醇激素治疗持续至少180天。
29、原发性硬化性胆管炎	指一种胆汁淤积综合征，其特征是肝内、肝外胆道因纤维化性炎症逐渐狭窄，并最终导致完全阻塞而发展为肝硬化。本病须经内镜逆行胰胆管造影等影像学检查证实，并须满足下列全部条件：总胆红素和直接胆红素同时升高，血清ALP200U/L；持续性黄疸病史；出现胆汁性肝硬化或门脉高压。因肿瘤或胆管损伤等继发性的硬化性胆管炎不在保障范围内。
30、侵蚀性葡萄胎（或称恶性葡萄胎）	该类疾病是指异常增生的绒毛组织浸润性生长浸入子宫肌层或转移至其他器官或组织的葡萄胎，并已经进行化疗或手术治疗的。
31、严重的胰岛素依赖型糖尿病（型糖尿病）	胰岛素依赖型糖尿病是由于胰岛素分泌不足引起的慢性血糖升高，并需持续性地依赖外源性胰岛素维持一百八十天以上，须由本公司认可的有资格的内分泌医生确诊并在本合同保险责任有效期内，满足下述至少一个条件：本公司认可的内分泌医生确定已出现增殖性视网膜病变；须植入心脏起搏器治疗心脏病；因坏疽需切除一只或以上脚趾。
32、急性出血坏死性胰腺炎手术	指被保险人因为急性出血坏死性胰腺炎已经接受了外科开腹手术治疗，以进行坏死组织清除、坏死病灶切除或胰腺切除。因饮酒所致的急性出血坏死性胰腺炎或经腹腔镜手术进行的治疗不在保障范围内。
33、慢性复发性胰腺炎	胰腺炎反复发作超过三次以上并导致胰腺功能紊乱和营养不良，已接受酶替代治疗。诊断必须有专科医生确认并且有内窥镜逆行胰胆管造影所证实。因酒精所致的慢性复发性胰腺炎除外。
34、胰腺移植	指因胰腺功能衰竭，已经实施了在全身麻醉下进行的胰腺的异体器官移植手术。单纯胰岛移植、部分胰腺组织或细胞的移植不在本保障范围内。
35、慢性肾上腺皮质功能衰竭	因为自身免疫功能紊乱，使肾上腺组织逐渐受损，而需要长期接受糖皮质激素及肾上腺皮质激素替代疗法。该病必须经专科医生确诊，并有以下报告作为证据：促肾上腺皮质激素(ACTH)刺激试验；胰岛素血糖减少测试；血浆促肾上腺皮质激素(ACTH)水平测定；血浆肾素活性(PRA)测定。慢性肾上腺皮质功能衰竭只对由自身免疫功能紊乱引起的承担保险责任，其他原因引起的除外。
36、肾髓质囊性病肾髓质囊性病的诊断须同时符合下列要求：	肾髓质有囊肿、肾小管萎缩及间质纤维化等病理改变；贫血、多尿及肾功能衰竭等临床表现；诊断须由肾组织活检确定。（本合同责任免除条款第一节第九项不适用于此病种。）
37、肺淋巴管肌瘤病	肺淋巴管肌瘤病是一种弥漫性肺部疾病，主要病理改变为肺间质、支气管、血管和淋巴管内出现未成熟的平滑肌异常增生，同时需满足下列条件：经组织病理学诊断；CT显示双肺弥漫性囊性改变；血气提示低氧血症，动脉血氧分压（PaO2）持续50mmHg。
38、原发性骨髓纤维化	原发性骨髓纤维化为原因不明的骨髓中成纤维细胞增殖，伴有髓外造血，表现为进行性贫血、脾肿大等症状。本病必须根据骨髓的活组织检查和周围血象检查由血液科专科医生明确诊断，并至少符合下列条件中的三项，且符合条件的状态持续180天及以上，并已经实际接受了针对此症的治疗：血红蛋白100g/L；白细胞计数2510/L；外周血原始细胞1；血小板计数10010/L。任何其它病因导致的继发性骨髓纤维化不在保障范围内。
39、严重骨髓增生异常综合征(MDS)	是起源于造血干细胞的一组异质性髓系克隆性疾病，特点是髓系细胞发育异常，表现为无效造血、难治性血细胞减少，本合同所指的严重的骨髓增生异常综合征需满足下列所有条件：由设有专门血液病专科的医院血液病专科的主治级别以上的医师确诊；骨髓涂片检查同时符合发育异常细胞比例10、原始细胞比例15；已接受至少累计三十日的化疗或已接受骨髓移植治疗。化疗日数的计算以被保险人实际服用、注射化疗药物的天数为准。疑似病例不在保障范围之内。
40、肺泡蛋白质沉积症	指肺泡和细支气管腔内充满不可溶性富磷脂蛋白的疾病，胸部X线呈双肺弥漫性肺部磨玻璃影，病理学检查肺泡内充满有过碘酸雪夫（PAS）染色阳性的蛋白样物质，并且接受了肺灌洗治疗。
41、嗜铬细胞瘤	指发生在肾上腺或肾上腺外嗜铬组织的以分泌过多的儿茶酚胺为表现的神经内分泌肿瘤。嗜铬细胞瘤必须由内分泌专科医生诊断，并且满足以下所有条件：临床有高血压症候群表现；已经实施了嗜铬细胞瘤切除手术。
42、严重自身免疫性肝炎	是一种原因不明的慢性肝脏的坏死性炎性疾病，机体免疫机制被破坏，产生针对肝脏自身抗原的抗体导致自身免疫反应，从而破坏肝细胞造成肝脏炎症坏死，进而发展为肝硬化。必须满足所有以下条件：高球蛋白血症；血液中存在高水平的自身免疫抗体，如ANA（抗核抗体）、SMA（抗平滑肌抗体）、抗LKM1抗体或抗SLA/LP抗体；肝脏活检证实免疫性肝炎；临床已经出现腹水、食道静脉曲张和脾肿大等肝硬化表现。变和角膜边缘有铜盐沉着环为其临床特征，并须满足下列全部条件：典型症状；角膜色素环（KF环）；血清铜和血清铜蓝蛋白降低，尿铜增加；经皮做肝脏活检来定量分析肝脏铜的含量。（本合同责任免除条款第一节第九项不适用于此病种。）
44、糖尿病导致的双脚截肢	因糖尿病引起的神经及血管病变而经本公司认可的医院的专科医生确认，由踝关节或踝关节近端（靠近躯干端）以上位置截除双脚是维持生命的唯一方法。切除一只或多只脚趾或因任何其他原因引起的截肢术不在保障范围内。
45、自体造血干细胞移植术	指由于患者罹患血液系统恶性肿瘤导致自身骨髓造血功能异常，为了达到治疗该血液肿瘤的目的，采集患者自身的一部分造血干细胞，分离并深低温保存再回输给患者，以重建患者的造血功能和免疫功能的一种治疗方式。该治疗必须是医疗必需的且已经在本公司认可的医院由专科医生实施完成。
46、多发性硬化	被保险人因脑及脊髓内的脱髓鞘病变而出现神经系统多灶性（多发性）多时相至少6个月以内有一次以上（不包含一次）的发作的病变，须由计算机断层扫描（CT）、核磁共振检查（MRI）或正电子发射断层扫描（PET）等影像学检查证实，且已经造成自主生活能力完全丧失，无法独立完成六项基本日常生活活动中的三项或三项以上，持续至少180天。
47、颅脑手术	被保险人确已实施全麻下的开颅手术（不包括颅骨钻孔手术和经鼻蝶窦入颅手术）。因外伤而实施的脑外科手术不在保障范围之内。理赔时必须提供由专科医生出具的诊断书及手术报告。
48、重症肌无力	是指一种神经与肌肉接头部位传递障碍的自身免疫性疾病，临床特征是局部或全身横纹肌于活动时易于疲劳无力，颅神经眼外肌最易累及，也可涉及呼吸肌、下肢近端肌群以至全身肌肉，须经专科医生确诊。其诊断必须同时具有下列情况：经药物、胸腺手术治疗一年以上无法控制病情，丧失正常工作能力；出现眼睑下垂，或延髓肌受累引起的构音困难、进食呛咳,或由于肌无力累及延髓肌、呼吸肌而致机体呼吸功能不正常的危急状态即肌无力危象；症状缓解、复发及恶化交替出现，临床接受新斯的明等抗胆碱酯酶药物治疗的病史。
49、脊髓灰质炎	是由于脊髓灰质炎病毒感染所致的瘫痪性疾病，临床表现为运动功能损害或呼吸无力。脊髓灰质炎必须明确诊断。本保单仅对脊髓灰质炎造成的神经系统功能损害导致被保险人一肢或一肢以上肢体机能永久完全丧失的情况予以理赔。肢体机能永久完全丧失，指疾病确诊180天后，每肢三大关节中的两大关节仍然完全僵硬，或不能随意识活动。
50、严重肌营养不良症	是一组原发于肌肉的遗传性的肌肉病变。主要临床特征为受累骨骼肌肉的无力和肌肉萎缩。经专科医生确认符合以下四项诊断指标中的三项：家族史中有其他成员患相同疾病；临床表现包括：无感觉神经紊乱，正常脑脊液及轻微腱反射的减退；典型的肌电图；临床推测必须有肌肉或组织检查加以证实。
51、植物人状态	指脑皮质广泛性坏死而导致对自身及周边的认知能力完全丧失,但脑干功能依然存在。必须由专科医生明确诊断,并有头颅断层扫描（CT），核磁共振检查（MRI）或正电子发射断层扫描（PET）等影像学检查证实。上述情况必须有至少一个月的病历记录加以证实。由于酗酒或滥用药物所致的植物人状态不在保障范围内。
52、破裂脑动脉瘤夹闭手术	指因脑动脉瘤破裂造成蛛网膜下腔出血，被保险人实际接受了在全麻下进行的开颅动脉夹闭手术。脑动脉瘤（未破裂）预防性手术、颅骨打孔手术、动脉瘤栓塞手术、血管内手术及其他颅脑手术不在本保障范围内。
53、疯牛病	神经系统疾病及致命的成胶质状脑病，并有以下症状：不能控制的肌肉痉挛及震颤；逐渐痴呆；小脑功能不良，共济失调；手足徐动症；诊断必须由专科医生基于以下检查报告作出：脑电图、脑脊液报告、电脑断层扫描(CT)及核磁共振(MRI)。
54、严重癫痫	本病的诊断须由神经科或儿科专科医生根据典型临床症状和脑电图及MRI、PET、CT等影相学检查做出。理赔时必须提供6个月以上的相关病历记录证明被保险人存在经抗癫痫药物治疗无效而反复发作的强直阵挛性发作或癫痫大发作，或者已进行神经外科手术以治疗反复发作的癫痫。热性惊厥以及没有全身性发作的失神发作（癫痫小发作）不在本保障范围内。
55、严重细菌性脑脊髓膜炎	指因脑膜炎双球菌感染引起脑脊髓膜化脓性病变，且导致永久性神经损害．．．．．．．（见注7），持续90天以上，并且脑脊液检查显示脑膜炎双球菌阳性。注7：永久性神经损害是指由细菌性脑脊髓膜炎引起的耳聋、失明、动眼神经麻痹、瘫痪、脑积水、智力或性情中度以上的损害，且上述症状持续90天以上仍无改善迹象。疹。经专科医生确诊为患有手足口病，并伴有下列三项中任意一项并发症：有脑膜炎或脑炎并发症，且导致意识障碍或瘫痪的临床表现及实验室检查证据；有肺炎或肺水肿并发症，且导致呼吸衰竭的临床表现及实验室检查证据；有心肌炎并发症，且导致心脏扩大或心力衰竭的临床表现及实验室检查证据。
57、成骨不全症	一种胶原病，特征为骨易碎，骨质疏松和易骨折。该病有4种类型：I型、型、型、型。只保障型成骨不全的情形。其主要临床特点有：发展迟缓、多发性骨折、进行性脊柱后侧凸及听力损害。型成骨不全的诊断必须根据身体检查，家族史，X线检查和皮肤活检报告资料确诊。（本合同责任免除条款第一节第九项不适用于此病种。）
58、进行性核上性麻痹	进行性核上性麻痹（PSP）又称SteeleRchardsonOIszewski综合症，是一种神经系统变性疾病，以假球麻痹、垂直性核上性眼肌麻痹、锥体外系肌僵直、步态共济失调和轻度痴呆为主要临床特征。PSP必须由医院的神经内科专科医生确诊，并且被保险人自主生活能力完全丧失，无法独立完成六项基本日常生活活动中的三项或三项以上。
59、严重瑞氏综合征	瑞氏综合征是线粒体功能障碍性疾病。导致脂肪代谢障碍，引起短链脂肪酸、血氨升高，造成脑水肿。主要临床表现为急性发热、反复呕吐、惊厥及意识障碍等等。肝脏活检是确诊的重要手段。瑞氏综合征需由医院的儿科专科医生确诊，并符合下列所有条件：有脑水肿和颅内压升高的脑脊液检查和影像学检查证据；血氨超过正常值的3倍；临床出现昏迷，病程至少达到疾病分期第3期。
60、肾上腺脑白质营养不良	指一种最常见的过氧化物酶体病，主要累及肾上腺和脑白质，主要表现为进行性的精神运动障碍，视力及听力下降和（或）肾上腺皮质功能低下等。须经专科医生诊断，且已经造成自主生活能力完全丧失，无法独立完成六项基本日常生活活动中的三项或三项以上，持续至少180天。本合同仅对三周岁以上的被保险人予以理赔。（本合同责任免除条款第一节第九项不适用于此病种。）
61、婴儿进行性脊肌萎缩症	该病是累及脊髓前角细胞及延髓运动核的神经元退行性变性病。在出生后两年内出现的脊髓和脑干颅神经前角细胞进行性机能障碍，伴随肌肉无力和延髓机能障碍。该病必须经由神经科医师通过肌肉活检而确诊。理赔时必须提供肌肉活检的病理报告。其它类型的脊肌萎缩症如型中间型进行性脊肌萎缩症，型少年型脊肌萎缩症(KugelbergWelander氏病)不在本保障范围之内。
62、脊髓小脑变性症	脊髓小脑变性症为一组以小脑萎缩和共济失调为主要临床特点的疾病。必须符合所有以下条件：脊髓小脑变性症必须由医院诊断，并有以下证据支持：1.1影像学检查证实存在小脑萎缩；1.2临床表现存在共济失调、语言障碍和肌张力异常。被保险人运动功能严重障碍，自主生活能力完全丧失，无法独立完成六项基本日常生活活动中的三项或三项以上。
63、进行性多灶性白质脑病	是一种亚急性脱髓鞘性脑病，常常发现于免疫缺陷的病人。必须由神经科专科医生根据脑组织活检确诊。
64、亚急性硬化性全脑炎	是麻疹或麻疹样病毒所致的一种中枢神经系统慢性感染。中枢神经系统呈现灰质和白质破坏为特征的慢性和急性混合存在的炎症。必须满足以下所有条件：脑电图存在周期性复合波、脑脊液r球蛋白升高、脑脊液和血清中麻疹抗体滴定度升高；被保险人出现运动障碍，自主生活能力完全丧失，无法独立完成六项基本日常生活活动中的三项或三项以上。
65、原发性脊柱侧弯矫正手术	指被保险人因原发性脊柱侧弯，实际实施了对该病的矫正外科手术。但由于先天性脊柱侧弯以及其他疾病或意外导致的继发性脊柱侧弯而进行的手术治疗不属于本保障责任。
66、多处臂丛神经根性撕脱	指由于疾病或意外导致至少两根臂丛神经根性撕脱，所造成的手臂感觉功能与运动功能完全永久性丧失。该病须由医院专科医生明确诊断，并且有电生理检查结果证实。
67、严重结核性脑膜炎	由结核杆菌引起的脑膜和脊膜的非化脓性炎症性疾病。需满足以下全部条件：出现颅内压明显增高，表现头痛、呕吐和视乳头水肿；出现部分性、全身性癫痫发作或癫痫持续状态；昏睡或意识模糊；视力减退、复视和面神经麻痹。
68、严重的原发性心肌病	指不明原因引起的一类心肌病变，包括原发性扩张型心肌病、原发性肥厚型心肌病及原发性限制型心肌病三种，病变必须已造成事实上心室功能障碍而出现明显的心功能衰竭（指按照美国纽约心脏病学会提出的新功能状态分级的标准判定，心功能状态已达IV级），且有相关住院医疗记录显示IV级心功能衰竭状态已持续至少180日。本病须经专科医生明确诊断。继发于全身性疾病或其他器官系统疾病造成的心肌病变不在保障范围内。
69、象皮病	指末期丝虫病，按国际淋巴学会分级为三度淋巴水肿，其临床表现为肢体非凹陷性水肿伴畸形增大、硬皮症和疣状增生。此病症须经专科医生根据临床表现和微丝蚴的化验结果确诊。
70、系统性红斑狼疮型或以上狼疮性肾炎	系统性红斑狼疮是由多种因素引起，累及多系统的自身免疫性疾病。其特点是生成自身抗体对抗多种自身抗原。多见于育龄妇女。本保单所指的系统性红斑狼疮仅限于累及肾脏（经肾脏活检确认的，符合WHO诊断标准定义III型至V型狼疮性肾炎）的系统性红斑狼疮。其他类型的红斑性狼疮，如盘状狼疮、仅累及血液及关节的狼疮不在本保单保障范围取１静”匦胗擅庖吆头缡科专家医师确诊。世界卫生组织（WHO）狼疮性肾炎分型：型（微小病变型）镜下阴性，尿液正常型（系膜病变型）中度蛋白尿，偶有尿沉渣改变型（局灶及节段增生型）蛋白尿，尿沉渣改变型（弥漫增生型）急性肾炎伴有尿沉渣改变及/或肾病综合征型（膜型）肾病综合征或重度蛋白尿若本项疾病已经赔付，那么后续因本项疾病导致的重大疾病所属组别A组中的重大器官移植术或造血干细胞移植术将不再进行赔付。
71、严重类风湿性关节炎	严重类风湿性关节炎为广泛分布的慢性进行性多关节病变，伴有关节严重变形，侵犯至少三个主要关节（腕关节、肘关节、肩关节、踝关节、膝关节、髋关节）或关节组（如手的多个指间、掌指关节，足的多个足趾、跖趾关节），X线显示严重的关节（软骨和骨）破坏和关节畸形，并已达到类风湿性关节炎功能分级IV级的永久不可逆性关节功能障碍，致使被保险人完全丧失工作能力，生活不能自理，无法独立完成六项基本日常生活活动中的三项或三项以上。
72、严重冠心病	指根据冠状动脉造影检查结果确诊的主要血管严重狭窄性病变，须满足下列至少一项条件：左冠状动脉主干和右冠状动脉有一支血管管腔直径减少75以上且另一支血管管腔直径减少60以上。前降支、左旋支和右冠状动脉至少一支血管管腔直径减少75以上且其他两支血管管腔直径减少60以上。前降支、左旋支及右冠状动脉的分支血管的狭窄不作为本保障的衡量指标。
73、严重心肌炎	指因严重心肌炎性病变导致心功能损害造成持续的永久不可逆性的心功能衰竭。必须满足所有以下条件：心功能衰竭程度达到纽约心脏病学会的心功能分级标准之心功能IV级，或左室射血分数低于30；持续不间断180天以上；被保险人永久不可逆性的体力活动能力受限，不能从事任何体力活动。
74、主动脉夹层血肿	是指主动脉壁在受到某些病理因素的破坏后，高速、高压的主动脉血流将其内膜撕裂，以致主动脉腔内的血流通过主动脉内膜的破裂口进入主动脉内壁而形成血肿。被保险人需通过X线断层扫描（CT）、磁共振扫描（MRI）、磁共振血管检验法（MRA）或血管扫描等检查，并且实施了胸腹切开的直视主动脉手术。
75、度房室传导阻滞	指心房激动在房室交界区、房室束及其分支内发生阻滞，不能正常地传到心室的心脏传导性疾病，须满足下列所有条件：心电图显示房室搏动彼此独立，心室率50次/分钟；出现阿斯综合征或心力衰竭的表现；必须持续性依赖心脏起搏器维持心脏正常功能，且已经放置心脏起搏器。
76、严重传染性心内膜炎	是指由感染性微生物引致的心脏内膜炎症，并须符合下列所有准则：血液培植结果呈阳性反应，证明感染性微生物的存在；出现最少中度之心脏瓣膜功能不全（即返流部份达百分之二十或以上）或中度之心脏瓣膜狭窄（即心脏瓣面积为正常值的百分之三十或以下），导致传染性心内膜炎；传染性心内膜炎的诊断及瓣膜受损的严重程度必须由专科医生确定。心功能衰竭程度达到美国纽约心脏病学会心功能状态分级IV级。被保险人永久不可逆性的体力活动能力受限，不能从事任何体力活动。
78、全身型幼年类风湿性关节炎（斯蒂尔氏病）	指小儿及青少年时期的一种全身结缔组织病。可表现为驰张热、皮疹、关节炎、脾肿大、淋巴结肿大、浆膜炎、体重减轻、中性粒细胞增多等，全身症状可以先于关节炎出现。须满足下列全部条件：确诊且症状持续180天以上；已接受至少一侧膝关节或髋关节的置换手术。
79、严重川崎病	是指一种以损伤冠状动脉血管为主的系统性血管炎。其特点是贫血、白细胞计数及红细胞沉降率升高、或出现血小板增多症。须满足以下条件：自确诊后180天经过血管造影或超声心动图检查证实，仍存明显的冠状动脉瘤。
80、严重慢性缩窄型心包炎	由于慢性心包炎症导致心包脏层和壁层广泛瘢痕粘连、增厚和钙化，心包腔闭塞，形成一个纤维瘢痕外壳，使心脏和大血管根部受压，妨碍心脏的舒张。必需经心脏科专科医生明确诊断为慢性缩窄性心包炎，并且已经造成永久不可逆性的体力活动能力受限，达到美国纽约心脏病学会心功能状态分级IV级，并持续180天以上。
81、严重继发性肺动脉高压	继发性肺动脉压力持续增高，导致右心室肥厚，已经造成永久不可逆性的体力活动能力受限，达到美国纽约心脏病学会心功能状态分级IV级。诊断需要由心脏科专家确诊，并且心导管检查报告显示静息状态下肺动脉平均压超过30mmHg。所有先天性心脏疾病直接或间接引起的肺动脉高压不在保障责任范围内。
82、艾森门格综合征	因心脏病导致的严重肺动脉高压及右向左分流。诊断必须由心脏专科医生经超声心动图和心导管检查证实及需符合以下所有标准：平均肺动脉压高于40mmHg；肺血管阻力高于3mm/L/min（Wood单位）；正常肺微血管楔压低于15mmHg。（本合同责任免除条款第一节第九项不适用于此病种。）条件：红细胞沉降率及C反应蛋白高于正常值；超声检查、CTA检查或血管造影检查证实主动脉及其主要分支存在狭窄。
84、Brugada综合征85、严重巨细胞动脉炎	由心脏科专科医生根据临床症状和典型心电图表现，明确诊断为Brugada综合征。经医生判断认为医疗必须安装且实际已安装永久性心脏除颤器。巨细胞动脉炎又称颅动脉炎、颞动脉炎、肉芽肿性动脉炎，须经本公司认可医院的专科医师明确诊断，并造成永久不可逆性的单个肢体功能障碍或单眼失明。单眼失明指单眼视力永久不可逆性丧失，患眼须满足下列至少一项条件：眼球缺失或者摘除；矫正视力低于0.02（采用国际标准视力表，如果使用其它视力表应进行换算）；视野半径小于5度。
引起的坏疽	急剧恶化，已经立刻进行了手术及清创术。最后的诊断必须由微生物或病理学专家进行相关检查后证实。
87、坏死性筋膜炎坏死性筋膜炎的诊断须同时符合下列要求：	符合坏死性筋膜炎的一般临床表现；细菌培养检出致病菌；出现广泛性肌肉及软组织坏死，并导致身体受影响部位永久完全失去功能。所谓永久完全失去功能是指受影响部位的全部功能完全丧失超过180天者。
88、非阿尔茨海默病所致严重痴呆	指因阿尔茨海默病以外的脑的器质性疾病造成脑功能衰竭导致永久不可逆性的严重痴呆，临床表现为明显的认知能力障碍、行为异常和社交能力减退。被保险人自主生活能力完全丧失，无法独立完成六项基本日常生活活动中的三项或三项以上，日常生活必须持续受到他人监护。导致痴呆的疾病必须明确诊断，并且由完整的临床、实验室和影像学检查结果证实。神经官能症和精神疾病不在保障范围内。
89、经输血导致的人类免疫缺陷病毒（HIV）感染	被保险人因输血而感染上人类免疫缺陷病毒（HIV）必须满足以下的条件：在保障起始日或复效日之后，被保险人因必需输血而感染HIV；提供输血前一个月内HIV检查阴性的报告以及输血后HIV检查阳性的报告；提供输血治疗的输血中心或医院出具该项输血感染属医疗责任事故的报告，或者法院终审裁定为医疗责任；提供输血治疗的输血中心或医院必须拥有合法经营执照；受感染的被保险人不是血友病患者。在任何治愈艾滋病（AIDS）或阻止HIV病毒作用的疗法被发现以后，或能防止AIDS发生的医疗方法被研究出来以后，本保障将不再予以赔付。任何因其他传播方式（包括：性传播或静脉注射毒品）导致的HIV感染不在本合同保障范围内。我们拥有获得使用被保险人的所有血液样本的权利和能够对这些样本进行独立检验的权利。（本合同责任免除条款第一节第八项不适用于此病种。）
90、因职业关系导致的人类免疫缺陷病毒（HIV）感染	被保险人在其常规职业工作过程中遭遇外伤，或职业需要处理血液或其它体液时感染上人类免疫缺陷病毒（HIV）。必须满足下列全部条件：感染必须是在被保险人正在从事其职业工作中发生，该职业必须属于下列限定职业范围内的职业；血清转化必须出现在事故发生后的6个月以内；必须提供被保险人在所报事故后发生的5天以内进行的检查报告，该报告必须显示被保险人血液人类免疫缺陷病毒（HIV）阴性和/或人类免疫缺陷病毒（HIV）抗体阴性；必须在事故发生后的12个月内证实被保险人体内存在人类免疫缺陷病毒（HIV）或人类免疫缺陷病毒（HIV）抗体。限定职业：医生和牙科医生、护士、医院化验室工作人员、医院护工、医生助理和牙医助理、救护车工作人员、助产士、消防队员、警察、狱警。（本合同责任免除条款第一节第八项不适用于此病种。）管、内脏器官异常纤维化为特征的结缔组织病。本病须经专科医生明确诊断，并须满足下列至少一项条件：肺脏：肺部病变进而发展为肺间质纤维化和肺动脉高压；心脏：心功能受损达到美国纽约心脏病学会心功能状态分级IV级；肾脏：肾脏受损导致双肾功能慢性不可逆衰竭，达到尿毒症期。
92、严重克隆病	克隆病是一种慢性肉芽肿性肠炎，具有特征性的克隆病病理组织学变化。诊断必须由病理检查结果证实。被保险人所患的克隆病必须已经造成瘘管形成并伴有肠梗阻或肠穿孔。
93、埃博拉病毒感染	指埃博拉病毒感染导致的烈性传染病，并须满足下列全部条件：实验室检查证实埃博拉病毒的存在；从发病开始有超过30天的进行性感染症状。
94、严重肠道疾病并发症	严重肠道疾病或外伤导致小肠损害并发症，满足以下所有条件：至少切除了三分之二小肠；完全肠外营养支持三个月以上。
95、小肠移植	指因肠道疾病或外伤，已经实施了在全身麻醉下进行的小肠的异体器官移植术。此手术必须由专科医生认为是医学上必须的情况下进行。
96、一肢及单眼缺失	因疾病或意外伤害导致单眼视力丧失及任何一肢自腕关节或踝关节近端（靠近躯干端）以上完全性断离。单眼视力丧失指单眼视力永久不可逆性丧失，患眼须满足下列至少一项条件：眼球缺失或摘除；矫正视力低于0.02（采用国际标准视力表，如果使用其它视力表应进行换算）；视野半径小于5度。被保险人申请理赔时年龄必须在三周岁以上，并且提供理赔当时的视力丧失诊断及检查证据。投保时已有单眼缺失或有一肢缺失的不在保障范围内。
97、因器官移植导致的艾滋病病毒感染	指因进行器官移植而感染上人类免疫缺陷病毒（HIV）或患艾滋病，且须满足下列全部条件：在保障起始日或复效日之后，被保险人因治疗必需而实施器官移植，并且因器官移植而感染人类免疫缺陷病毒或患艾滋病；提供器官移植治疗的器官移植中心或医院出具的此次因器官移植感染人类免疫缺陷病毒或患艾滋病，属于医疗事故的报告，或者法院终审裁定为医疗事故并且不准上诉；提供器官移植治疗的器官移植中心或医院必须拥有合法经营执照。任何因其他传播方式（包括：性传播或静脉注射毒品）导致的HIV感染或患艾滋病不在保障范围内。
98、弥漫性血管内凝血	指血液凝固系统和纤溶系统的过度活动导致微血管血栓形成、血小板及凝血因子耗竭和严重出血，需要输注血浆和浓缩血小板进行治疗。须提供同时具有下列条件中的至少三项的检验报告：血小板计数10010/L或者呈进行性下降；血浆纤维蛋白原含量1.5g/L或者4g/L或者呈进行性下降；3P试验阳性或者血浆FDP20mg/L；凝血酶原时间15秒或者超过对照组3秒以上。
99、严重甲型及乙型血友病	被保人必须是患上严重甲型血友病（缺乏凝血因子）或严重乙型血友病（缺乏凝血因子），而凝血因子或凝血因子的活性水平少于百分之一。诊断必须由本公司认可医院的的血液病专科注册医生确认。大和循环衰竭（登革热休克综合症即符合WHO登革热第级及第级）。出血性登革热的诊断必须由本公司认可医院的专科注册医生证实。非出血性登革热并不在保障范围内。术治疗。经导管心室内成型手术治疗不在本保障范围内。
102、急性肺损伤（ALI）或急性呼吸窘迫综合征（ARDS）	一种表现为无心脏衰竭的肺水肿，为创伤、脓毒血症等临床多种疾病的并发症，造成多器官衰竭，死亡率高。急性肺损伤或急性呼吸窘迫综合征必须由呼吸系统专科医师诊断，被保险人理赔时年龄在二十五周岁以下，并有所有以下临床证据支持：急性发作（原发疾病起病后6至72小时）；急性发作的临床症状体征，包括呼吸急促、呼吸困难、心动过速、大汗、面色苍白及辅助呼吸肌活动加强（点头呼吸、提肩呼吸）；双肺浸润影；PaO2/FiO2（动脉血压分压/吸入气氧分压）低于200mmHg；肺动脉嵌入压低于18mmHg，临床无左房高压表现。范围指上至发际、下至下颌下缘、两侧至下颌支后缘之间的区域，包括额部、眼部、眶部、鼻部、口唇部、颏部、颧部、颊部和腮腺咬肌部。不承担因酸碱化学品导致的面部烧伤保险金给付责任。
104、湿性年龄相关性黄斑变性	又称为新生血管性年龄相关性黄斑变性或渗出性年龄相关性黄斑变性，发生脉络膜新生血管（CNV）异常生长穿透玻璃膜进入视网膜，新生血管渗漏，渗出及出血。该病必须由荧光素眼底血管造影检查提示黄斑区新生血管形成，并且必须由医院的眼科专科医生确诊为湿性年龄相关性黄斑变性。被保险人申请理赔时须提供近3个月内视力改变显示病情恶化的相关检查报告、诊断证明及病历报告。
105、溶血性尿毒综合征	一种由于感染导致的急性综合征，引起红细胞溶血，肾功能衰竭及尿毒症。溶血尿毒综合征必须由血液和肾脏专科医师诊断，被保险人理赔时年龄在二十五周岁以下，并且满足下列所有条件：实验室检查确认有溶血性贫血、血尿、尿毒症、血小板减少性紫癜；因肾脏功能衰竭实施了肾脏透析治疗。任何非因感染导致的溶血性贫血，如：自身免疫性溶血性贫血、与红细胞膜缺陷有关的溶血性贫血、红细胞酶病、血红蛋白病等，不在本保障范围内。
10.8首次患本合同约定指被保险人患同时符合以下条件的轻症疾病：	(一)被保险人自出生后首次出现该轻症疾病之症状体征；
的轻症疾病	(二)被保险人在本合同有效期间内首次出现该轻症疾病之症状体征并被确诊患该轻症疾病；(三)该轻症疾病之症状体征符合本合同的定义；(四)该轻症疾病已在本合同中列明。对于被保险人在本合同生效日前出现的本合同所列的轻症疾病，本公司不承担给付保险金责任。
10.9轻症疾病	指被保险人发生符合以下疾病定义所述条件的疾病（共55种），应当由专科医生明确诊断。
1、非危及生命的（极早期的）恶性病变	指经组织病理学检查被明确诊断为下列恶性病变，并且接受了相应的治疗。原位癌；相当于Binet分期方案A期程度的慢性淋巴细胞白血病；相当于AnnArbor分期方案I期程度的何杰金氏病；皮肤癌（不包括恶性黑色素瘤及已发生转移的皮肤癌）；TNM分期为TNM期或更轻分期的前列腺癌。以下标准。肾小球滤过率（GFR）25ml/min或肌酐清除率（Ccr）25ml/min；血肌酐（Scr）5mg/dl或442umol/L；持续180天。
3、肾脏切除	因肾脏疾病或外伤而确实已经接受手术切除左肾和/或右肾。手术必须被本公司认可医院的专科注册医生视为必要的。因捐赠肾脏而所需的手术或部分切除不在保障范围内。
4、急性出血坏死性胰腺炎腹腔镜手术	指被保险人被确诊为急性出血性坏死性胰腺炎，并实际接受了腹腔镜手术治疗，以进行坏死组织清除、坏死病灶切除或胰腺切除。因酗酒或饮酒过量所致的急性坏死性胰腺炎不在本保单保障范围内。
5、肝叶切除	指因疾病或意外伤害实际实施的肝脏部分切除术，手术须有至少一个完整的肝叶切除。
6、单侧肺脏切除	因疾病或意外伤害实际实施的一侧肺脏切除术，部分切除手术和肺脏捐献引起的手术不在保障范围内。
7、双侧卵巢或睾丸切除术	指为治疗疾病实际接受了双侧卵巢或双侧睾丸完全切除手术。部分卵巢或睾丸切除不在保障范围。
8、胆总管小肠吻合术	因疾病或胆道损伤导致实际接受涉及胆总管小肠吻合术的胆道重建手术。诊断及治疗均须在本公司认可的医院内由专科医师认为是医疗必须的情况下进行。因胆道闭锁等先天性疾病而导致进行的胆道手术并不在本保障范围取
9、中度严重溃疡性结肠炎	本保障所指的溃疡性结肠炎须满足下列所有理赔条件：须经由内窥镜检查证实该疾病侵犯全部结肠及直肠；活检病理学组织切片检查证实为溃疡性结肠炎；经专科医生以类固醇或免疫抑制剂连续治疗至少180天。诊断及治疗均须在本公司认可的医院内由专科医师认为是医疗必须的情况下进行。
10、中度严重克隆病	克隆病是一种慢性肉芽肿性肠炎，具有特征性的克隆病病理组织学变化。诊断必须由本公司认可医院的专科注册医生经内窥镜及肠病理活检结果证实，同时经专科医生以类固醇或免疫抑制剂连续治疗至少180天，方符合理赔条件。
11、糖尿病视网膜晚期增生性病变	因糖尿病而并发视网膜晚期增生性血管病变，并必须符合下列所有理赔条件：确诊糖尿病视网膜病变时被保人已患有糖尿病；双眼最佳矫正视力低于0.3（采用国际标准视力表，如果使用其他视力表应进行换算。以Snellen视力检查表的标准，双眼最佳矫正视力为6/18或更差）；被保人已确实进行了激光治疗等以改善视力障碍；糖尿病视网膜病变的诊断、视力障碍的程度及治疗的医疗之必要性必须由本公司认可医院的眼科专科注册医生确定。
12、糖尿病肾病	指被保险人被确诊为糖尿病，且因该病导致糖尿病肾病，必须满足下列全部条件：肾小球滤过率（使用MDRD公式或CockcroftGault公式计算的结果），低于25mL/min/1.73平方米，且此状态须持续至少90天；持续性大量蛋白尿（UAE200g/min）或蛋白尿大于500mg/d；慢性肾功能障碍的诊断必须由泌尿科或肾脏科医师确认。
13、早期肝硬化	早期肝硬化：肝硬化为各种慢性肝病发展的晚期阶段。肝硬化须由专科医生明确诊断。必须由活检证实有再生的肝细胞结节和典型的肝组织纤维化。下列条件必须全部满足并至少持续一年：持续性黄疸，胆红素水平升高超过50mol/L；蛋白质合成异常，白蛋白水平低于27g/L；异常凝血功能，凝血酶原时间超过正常上限的2倍或以上，或者国际正常化比率（INR）在2.0以上。因酒精，毒品或药物滥用导致的肝硬化不在保障范围内。
14、因肾上腺腺瘤的肾上腺切除术	因肾上腺腺瘤所导致醛固酮分泌过多而产生的续发性恶性系统高血压而接受肾上腺切除术。恶性高血压无法由药物控制。此肾上腺切除术需由专科医生确诊为处理高血压控制不佳的必要治疗行为。
15、可逆性再生障碍性贫血	指因急性可逆性的骨髓造血功能衰竭而导致贫血、中性粒细胞减少和血小板减少，必须由血液科医生的诊断，且病历资料显示接受了下列任一治疗：骨髓刺激疗法至少累计三十日；免疫抑制剂治疗至少累计三十日；接受了骨髓移植。
16、不典型的急性心肌梗塞	指被临床诊断为急性心肌梗塞并接受了急性心肌梗塞治疗虽然未达到重大疾病急性心肌梗塞的给付标准，但满足下列全部条件：肌钙蛋白有诊断意义的升高；心电图有损伤性的ST段改变但未出现病理Q波。
17、微创冠状动脉搭桥术	微创冠状动脉搭桥手术是指确实透过微型的胸壁锁孔（于肋骨之间开一个细小的切口），进行非体外循环下的冠状动脉搭桥手术，以矫正一条或以上冠状动脉狭窄或闭塞。微创进行直接的冠状动脉搭桥手术亦可称锁孔式冠状动脉手术。有关程序为医疗所需及由本公司认可医院的心脏专科医生进行。
18、冠状动脉介入手术（非开胸手术）	为了治疗明显的冠状动脉狭窄性疾病，首次实际实施了冠状动脉球囊扩张成形术、冠状动脉支架植入术、冠状动脉粥样斑块切除术或激光冠状动脉成形术。
19、心脏瓣膜介入手术（非开胸手术）	为了治疗心脏瓣膜疾病，实际实施了非开胸的经胸壁打孔内镜手术或经皮经导管介入手术进行的心脏瓣膜置换或修复手术。
20、主动脉内手术（非开胸手术）	为了治疗主动脉疾病实际实施了经皮经导管进行的动脉内手术。主动脉指胸主动脉和腹主动脉，不包括胸主动脉和腹主动脉的分支血管。手术必须在心脏科医生认为是医学上必需的情况下进行。投保时已经缺失一侧的不在保障范围内。
22、植入心脏起搏器	指被保险人因心脏起搏传导系统疾病，依照永久性起搏治疗指征，实际接受了永久性心脏起搏器植入手术。临时心脏起搏器安装除外。
23、颈动脉狭窄介入治疗	颈动脉血管介入治疗术是对一条或以上的颈动脉狭窄的治疗，疾病的诊断及治疗均须在本公司认可的医院内由专科医师认为是医疗必须的情况下进行。理赔时必须同时符合下列所有条件：经由血管造影术证明一条或以上的颈动脉存在50或以上M窄；确实已针对以上狭窄血管进行介入治疗以减轻症状，介入治疗包括血管成形术及/或进行植入支架或颈动脉粥肿斑块清除手术。
24、特定周围动脉疾病的血管介入治疗	指为治疗一条或者一条以上的下列动脉狭窄而实施的血管介入治疗：为下肢或者上肢供血的动脉。上肢动脉指：肱动脉及其下行分支血管；下肢血管指：股动脉及其下行分支血管；肾动脉；肠系膜动脉。须满足下列全部条件：经血管造影术证实一条或者一条以上的上述动脉狭窄达到50或者以上；对一条或者一条以上的上述动脉施行了血管介入治疗，如血管成形术及/或者进行植入支架或者动脉粥样瘤清除手术。上述动脉疾病的诊断以及相关治疗的必要性必须由血管疾病的专科医生确定。
25、早期原发性心肌病	被诊断为原发性心肌病，并符合下列所有条件：导致心室功能受损，其受损程度达到美国纽约心脏病学会心脏功能分级的第级，或其同等级e，即：体力活动明显受限，休息时无症状，轻于日常的活动即可引起充血性心力衰竭的症状。左室射血分数LVEF35。原发性心肌病的诊断必须由本公司认可医院的心脏专科注册医师确认，并提供心脏超声检查结果报告。本保障范围内的心肌病包括扩张型心肌病、肥厚型心肌病及限制型心肌病。继发于全身性疾病或其它器官系统疾病及酒精滥用造成的心肌病变不在保障范围内。
26、中度阿尔兹海默病	指因大脑进行性、不可逆性改变导致智能严重衰退或丧失，临床表现为明显的认知能力障碍、行为异常和社交能力减退，其日常生活必须持续受到他人监护。须由头颅断层扫描（CT）、核磁共振检查（MRI）或正电子发射断层扫描（PET）等影像学检查证实，且自主生活能力完全丧失，无法独立完成六项基本日常生活活动中的两项。
27、心脏起搏器或除颤器植入	因严重心律失常而于心腔内进行植入永久性心脏起搏器或除颤器的手术，此严重心律失常并不能以其他方法治疗。必须由相关专科医生确认植入心脏起搏器或除颤器为医疗所须。
28、植入腔静脉过滤器	指患者因反复肺栓塞发作，抗凝血疗法无效而接受手术植入腔静脉过滤器。此手术须在本公司认可医院内由专科医生认为是医疗必须的情况下进行。
29、原发性肺动脉高压	指不明原因的肺动脉压力持续性增高，进行性发展而导致右心室肥厚，已经造成永久不可逆性的体力活动能力受限，达到美国纽约心脏病学会心功能状态分级级，且静息状态下肺动脉平均压超过25mmHg。
30、中度脑炎或脑膜炎后遗症	指因患脑炎或脑膜炎导致的神经系统的永久功能障碍。神经系统永久性的功能障碍，指疾病确诊180天后，仍存在自主活动能力完全丧失，无法独立完成六项基本日常生活活动中的两项。
31、中度脑损伤	指因头部遭受机械性外力，引起脑重要部位损伤，导致神经系统永久性的功能障碍。须由头颅断层扫描（CT）、核磁共振检查（MRI）或正电子发射断层扫描（PET）等影像学检查证实。神经系统永久性的功能障碍，指脑损伤180天后，仍完全丧失自主生活能力，无法独立完成六项基本日常生活活动中的两项或以上。
32、脑垂体瘤、脑囊肿、脑动脉瘤及脑血管瘤	指经头颅断层扫描（CT）、核磁共振（MRI）或其他影像学检查被确诊为下列病变，并实际接受了手术或放射治疗。脑垂体瘤；脑囊肿；脑动脉瘤、脑血管瘤。
33、中度运动神经元病	是一组中枢神经系统运动神经元的进行性变性疾病，进行性脊肌萎缩症、进行性延髓麻痹症、原发性侧索硬化症、肌萎缩性侧索硬化症。须满足自主生活能力完全丧失，无法独立完成六项基本日常生活活动中的两项。
34、轻微脑中风后遗症	实际发生了脑血管的突发病变出现神经系统功能障碍表现，并接受住院治疗，头颅断层扫描（CT）、核磁共振（MRI）等影像学检查证实存在对应病灶，确诊为脑出血、脑栓塞或脑梗塞，在确诊180天后仍然遗留一肢或一肢以上肢体肌力级或级以下的运动功能障碍。
35、中度瘫痪	指因疾病或意外伤害导致一肢肢体机能永久完全丧失，肢体机能永久完全丧失，指疾病确诊180天后或意外伤害发生180天后，该肢三大关节中的两大关节仍然完全僵硬，或不能随意识活动。因外伤而实施的脑外科手术不在保障范围内。
37、植入大脑内分流器	指被保险人因疾病或外伤导致脑积水，经本公司认可的神经外科专科医生确诊，并且确认因医疗需要必须且已经实际植入了大脑内分流器，以降低脑脊液压力。先天性脑积水不在本保障范围内。
38、深度昏迷72小时	指因疾病或意外伤害导致意识丧失，对外界刺激和体内需求均无反应，昏迷程度按照格拉斯哥昏迷分级(Glasgowcomascale)结果为5分或5分以下，且已经持续使用呼吸机及其他生命维持系统达到72小时。断离。
40、单耳失聪	指因疾病或意外伤害导致单耳或双耳听力永久不可逆性丧失，在500赫兹，1000赫兹和2000赫兹语音频率下，平均听阈大于80分贝。需有纯音听力测试、声导抗检测或听觉诱发电位检测等证实。申请理赔时被保险人的年龄必须在3周岁以上，并需提供被保险人3周岁以后的听力受损诊断及相关检查报告。
41、人工耳蜗植入术	指由于耳蜗的永久损害而实际实施了人工耳蜗植入手术。诊断须经专科医生确认在医学上是必要的，且在植入手术之前已经符合下列全部条件：双耳持续12个月以上重度感音神经性耳聋；使用相应的听力辅助设备效果不佳。申请理赔时被保险人的年龄必须在3周岁以上，并需提供被保险人3周岁以后的耳蜗受损诊断及相关检查报告。失明的给付标准，但满足下列全部条件：双眼中较好眼矫正视力低于0.1（采用国际标准视力表，如果使用其他视力表应进行换算）；双眼中较好眼视野半径小于20度。申请理赔时，被保险人年龄必须在3周岁以上，并需提供被保险人3周岁以后的视力丧失诊断及相关检查报告，双侧眼球摘除不受此时间限制。
43、角膜移植	指为增进视力或治疗某些角膜疾患，已经实施了异体的角膜移植手术。此手术必须在本公司认可医院内由专科医生认为是医疗必须的情况下进行。
44、单目失明	指因疾病或意外伤害导致单眼视力永久不可逆性丧失，须满足下列至少一项条件：眼球缺失或摘除；矫正视力低于0.02（采用国际标准视力表，如果使用其它视力表应进行换算）；视野半径小于5度。
45、全身较小面积度烧伤	指烧伤程度为度，且度烧伤的面积达到全身体表面积的15或15以上。体表面积根据中国新九分法计算。
46、意外受伤所需的面部重建手术	指为修复意外伤害或暴力袭击造成的面部毁损，实际接受了在全身麻醉的情r下，由整形外科医生实施的对严重缺陷、缺失、损害或变形的面部形态和结构进行修复或重建的面部整形手术。面部整形手术必须在意外伤害后的180天内实施。因面部外伤后遗留的线条状瘢痕及色素沉着而施行的手术不在保障范围内。意外伤害必须满足下列全部条件：由外在暴力引起并且造成表面可视性伤口和面部骨结构损害的，或面部皮肤三度或全层意外烧伤；是造成面部毁损的直接和独立的原因。
47、中度严重类风湿性关节炎	指一种慢性自身免疫性疾病，主要表现为慢性、进行性多关节病变。本病须经专科医生明确诊断，须满足下列所有条件:至少包括下列关节中的二组或以上有广泛受损和畸形改变：双手指关节、双腕关节、双肘关节、双膝关节、双髋关节、双踝关节、脊椎或双脚趾关节；X线检查可见类风湿性关节炎的典型变化；关节的畸形改变至少持续180天；自主生活能力完全丧失，无法独立完成六项基本日常生活活动中的二项或二项以上，至少持续180天。
48、中度严重系统性红斑狼疮	本保障所指的系统性红斑狼疮必须符合下列所有理赔条件：在下列5项情况中出现最少2项：关节炎：非磨损性关节炎，需涉及两个或以上关节；浆膜炎：胸膜炎或心包炎；肾病：24小时尿蛋白定量达到0.5克，或尿液检查出现细胞管型；血液学异常：溶血性贫血、白细胞减少、或血小板减少；抗核抗体阳性、或抗dsDNA阳性，或抗Smith抗体阳性。系统性红斑狼疮的诊断必须由本公司认可医院的风湿科或免疫系统专科医生确定。
49、严重阻塞性睡眠窒息症	必须经本公司认可的呼吸科专科医生，通过多导睡眠监测仪检查明确诊断为严重阻塞性睡眠呼吸暂停综合征（OSA），并必须同时符合以下两项条件：被保险人目前须在夜间接受持续气道正压呼吸器（CPAP）的治疗；须提供睡眠测试的文件证明，显示呼吸暂停低通气指数(AHI)30，并且夜间血氧饱和度监测平均值85。
50、中度肌营养不良症	指一组原发于肌肉的遗传性疾病，临床表现为与神经系统无关的肌肉无力和肌肉萎缩。须满足下列全部条件：肌肉组织活检结果满足肌营养不良症的肌肉细胞变性、坏死等阳性改变；自主生活能力严重丧失，无法独立完成六项基本日常生活活动中的两项或两项以上。（本合同责任免除条款第一节第九项不适用于此病种。）
51、中度帕金森氏病	是一种中枢神经系统的退行性疾病，临床表现为震颤麻痹、共济失调等。必须满足下列全部条件：药物治疗无法控制病情；自主生活能力完全丧失，无法独立完成六项基本日常生活活动中的两项。继发性帕金森综合症不在保障范围内。180天后，仍遗留下列一种或一种以上障碍：一肢或一肢以上肢体肌力级或级以下的运动功能障碍；自主生活能力部分丧失，无法独立完成六项基本日常生活活动中的二项或二项以上。该诊断必须由本公司认可医院的神经专科医生证实，并必须由适当的检查证明为结核性脊髓炎。
53、早期象皮病	指因丝虫感染导致淋巴管阻塞而造成身体组织出现严重淋巴水肿。此病症须经本公司认可医院的专科医生根据临床表现和微丝蚴的化验结果确诊。急性淋巴管炎或其它原因引起的淋巴水肿并不在保障范围取
54、激光心肌血运重建术	指患有顽固性心绞痛，经持续药物治疗后无改善，冠状动脉搭桥手术及经皮血管成形手术已失败或者被认为不适合。在本公司认可医院内实际进行了开胸手术下或者胸腔镜下的激光心肌血运重建术。
55、中度脊髓灰质炎	脊髓灰质炎是由于脊髓灰质炎病毒感染所致的瘫痪性疾病，临床表现为运动功能损害或呼吸无力。脊髓灰质炎必须明确诊断。本合同仅对脊髓灰质炎造成的神经系统功能损害导致被保险人持续瘫痪90天以上的情况予以理赔。
10.10意外伤害	指遭受外来的、突发的、非本意的、非疾病的客观事件直接致使身体受到的伤害。
10.11重大疾病分组	型或以上
10.12发病	指出现疾病的前兆或异常的身体状况，或已经显现足以促使一般普通谨慎人士引起注意、寻求诊断、治疗或护理的病症。
10.13专科医生	专科医生应当满足以下四项资格条件：(一)中华人民共和国医师资格证书；(二)具有有效的中华人民共和国医师执业证书，并按期到相关部门登记注册；(三)具有有效的中华人民共和国主治医师或主治医师以上职称的医师职称证书；(四)在二级或二级以上医院的相应科室从事临床工作三年以上。
10.14现金价值	一般指保单所具有的价值，通常体现为解除合同时，由本公司向您退还的那部分金额。
10.15轻症疾病分组	
10.16毒品	指中华人民共和国刑法规定的鸦片、海洛因、甲基苯丙胺（冰毒）、吗啡、大麻、可卡因以及国家规定管制的其他能够使人形成瘾癖的麻醉药品和精神药品，但不包括由医生开具并遵医嘱使用的用于治疗疾病但含有毒品成分的处方药品。
10.17酒后驾驶	指经检测或鉴定，发生事故时车辆驾驶人员每百毫升血液中的酒精含量达到或超过一定的标准，公安机关交通管理部门依据道路交通安全法的规定认定为饮酒后驾驶或醉酒后驾驶。
10.18无有效驾驶证驾驶	指下列情形之一：(一)没有驾驶证驾驶；(二)驾驶与驾驶证准驾车型不相符合的车辆；(三)驾驶员持审验不合格的驾驶证驾驶；(四)未经公安交通管理部门同意，持未审验的驾驶证驾驶；(五)持学习驾驶证学习驾车时，无教练员随车指导，或不按指定时间、路线学习驾车；(六)公安交通管理部门规定的其他无有效驾驶证驾驶的情况。
10.19无有效行驶证	指下列情形之一：(一)没有机动车行驶证；(二)未在法律规定期限内按时进行或通过安全技术检验。
10.20机动车	指以动力装置驱动或者牵引，能合法上道路行驶的供人员乘用的四轮及四轮以上轮式车辆。
10.21艾滋病病毒	人类免疫缺陷病毒（HIV）的简称，是造成人类免疫系统缺陷的一种病毒。
10.22艾滋病	获得性免疫力缺乏综合征（AIDS）的简称。在人体血液或其它样本中检测到人类免疫缺陷病毒或其抗体呈阳性，同时出现了明显临床症状或体征，则可认为患艾滋病。
10.23遗传性疾病	指生殖细胞或受精卵的遗传物质（染色体和基因）发生突变或畸变所引起的疾病，通常具有亲代传至后代的垂直传递的特征。
10.24先天性畸形、变形或染色体异常	指被保险人出生时就具有的畸形、变形或染色体异常。先天性畸形、变形或染色体异常按照世界卫生组织疾病和有关健康问题的国际统计分类（ICD10）确定。
10.25医疗机构	指经中华人民共和国卫生部门正式评定的二级或以上之公立医院，但不包括上述医院的分院、联合病房或联合病床，精神病院，专供康复、休养、戒毒、戒酒、护理、养老等非以直接诊治病人为目的之医疗机构。
10.26利息	指保单贷款的利息，按保单贷款的数额、经过天数和利率按日复利方式计算。利率将参照人民银行公布的同期贷款利率、公司自身资金成本及风险管控能力确定。
