question	answer
1.1合同订立	本保险条款、保险单或其他保险凭证、投保书、与保险合同有关的投保文件、合法有效的声明、批注、附贴批单、附加险合同、其他书面协议都是您与我们之间订立的保险合同的构成部分。长城吉康人生重大疾病保险合同以下简称为本主险合同。
1.2合同成立与生效	您提出保险申请且本公司同意承保，本主险合同成立，合同成立日期在保险单上载明。自本主险合同成立、本公司收取首期保险费并签发保险单的次日零时起本主险合同生效，具体生效日以保险单所载的日期为准。我们自生效日零时起开始承担本主险合同约定的保险责任。本主险合同生效日以后每年的对应日是保险单周年日。保险单年度、保险单月度、保险费到期日和保险单满期日均以该日期为基础计算。如果当月无对应的同一日，则以该月最后一日作为对应日。
1.3投保年龄	指投保时被保险人的年龄，投保年龄以周岁（见9.1）计算，本主险合同接受的投保年龄为0周岁（指出生满30日且已健康出院的婴儿）至60周岁。不同交费方式、交费期间及保险期间所接受的投保年龄区间会有所不同。
1.4犹豫期	自您签收本主险合同之日起，有10日的犹豫期。在此期间请您认真审视本主险合同，如果您认为本主险合同与您的需求不相符，您可以在此期间提出解除本主险合同，我们扣除不超过人民币10元的合同工本费后无息退还您所交纳的本主险合同对应的保险费。犹豫期内解除本主险合同时，您需要填写解除合同申请书，并提供您的保险合同及有效身份证件（见9.2）。自我们收到您解除合同的书面申请时起，本主险合同即被解除，对于合同解除前发生的保险事故，我们不承担保险责任。
1.5保险期间	本主险合同的保险期间由您与我们约定并在保险单上载明。保险期间自本主险合同生效日的零时起至保险单满期日的零时止。金额发生变更，则以变更后的金额为基本保险金额。
2.2未成年人身故保险金限制	为未成年人投保的人身保险，因被保险人身故给付的保险金总和不得超过国务院保险监督管理机构规定的限额，身故给付的保险金额总和约定也不得超过前述限额。
2.3保险责任	在本主险合同保险期间内且在本主险合同有效期内，我们承担如下保险责任：
轻症疾病保险金	若被保险人于本主险合同生效或最后一次复效之日起90日内（含第90日）因意外伤害（见9.3）以外的原因导致疾病且经专科医生（见9.4）明确诊断罹患（见9.5）本主险合同约定的轻症疾病（见9.6）的一种或多种，我们将向您返还本主险合同累计已交保险费（无息），同时本主险合同终止。若被保险人因意外伤害，或于本主险合同生效或最后一次复效之日起90日后因意外伤害以外的原因导致疾病且经专科医生明确诊断初次罹患（见9.7）本主险合同约定的轻症疾病，我们将按本主险合同基本保险金额的30给付轻症疾病保险金。每种轻症疾病只给付一次轻症疾病保险金，给付后该种轻症疾病的保险责任终止。本主险合同轻症疾病保险金累计给付次数以三次为限，当累计次数达到三次时，本项保险责任终止。
中症疾病保险金	若被保险人于本主险合同生效或最后一次复效之日起90日内（含第90日）因意外伤害以外的原因导致疾病且经专科医生明确诊断罹患本主险合同约定的中症疾病（见9.8）的一种或多种，我们将向您返还本主险合同累计已交保险费（无息），同时本主险合同终止。若被保险人因意外伤害，或于本主险合同生效或最后一次复效之日起90日后因意外伤害以外的原因导致疾病且经专科医生明确诊断初次罹患本主险合同约定的中症疾病，我们将按本主险合同基本保险金额的50给付中症疾病保险金。每种中症疾病只给付一次中症疾病保险金，给付后该种中症疾病的保险责任终止。本主险合同中症疾病保险金累计给付次数以两次为限，当累计次数达到两次时，本项保险责任终止。
重大疾病保险金	首次重大疾病保险金若被保险人于本主险合同生效或最后一次复效之日起90日内（含第90日）因意外伤害以外的原因导致疾病且经专科医生明确诊断罹患本主险合同约定的重大疾病（见9.9）的一种或多种，我们将向您返还本主险合同累计已交保险费（无息），同时本主险合同终止。若被保险人因意外伤害，或于本主险合同生效或最后一次复效之日起90日后因意外伤害以外的原因导致疾病且经专科医生明确诊断初次罹患本主险合同约定的重大疾病，我们将按以下三者中的最大者给付首次重大疾病保险金，给付后首次重大疾病保险金的保险责任终止。（一）被保险人经专科医生明确诊断初次罹患该首次重大疾病时本主险合同的基本保险金额；（二）被保险人经专科医生明确诊断初次罹患该首次重大疾病时本主险合同的现金价值（见9.10）；（三）被保险人经专科医生明确诊断初次罹患该首次重大疾病时本主险合同累计已交保险费（无息）。如果被保险人罹患的疾病为一种重大疾病，该种重大疾病即为首次重大疾病；如果被保险人罹患的疾病为两种或两种以上重大疾病，则最先被专科医生明确诊断罹患的重大疾病为首次重大疾病。若我们已按上述约定给付首次重大疾病保险金，则本主险合同的现金价值自该首次重大疾病保险金给付之日起降为零，同时本主险合同约定的身故或全残保险金、轻症疾病保险金、中症疾病保险金、疾病终末期保险金的保险责任终止。第二次重大疾病保险金在我们已按本主险合同的约定给付首次重大疾病保险金后，被保险人自首次重大疾病确诊之日起1年后，经专科医生明确诊断初次罹患另外一种或多种重大疾病，我们将按本主险合同基本保险金额给付第二次重大疾病保险金，同时本主险合同终止。
急性心肌梗塞二次给付保险金	若被保险人罹患的首次重大疾病为本主险合同约定的急性心肌梗塞（见9.11），自确诊之日起5年后，再次经专科医生确诊患有本条款约定的急性心肌梗塞，则我们按照基本保险金额给付急性心肌梗塞二次给付保险金。本主险合同给付的急性心肌梗塞二次给付保险金以一次为限，给付后本项保险责任终止。如果首次重大疾病非急性心肌梗塞，则本项责任终止。
脑中风后遗症二次给付保险金	若被保险人罹患的首次重大疾病为本主险合同约定的脑中风后遗症（见9.12），自确诊之日起5年后，再次经专科医生确诊患有本条款约定的脑中风后遗症，则我们按照基本保险金额给付脑中风后遗症二次给付保险金。本主险合同给付的脑中风后遗症二次给付保险金以一次为限，给付后本项保险责任终止。再次确诊的脑中风后遗症须由颅脑显影或影像学检查证实为新一次的中风，并符合重大疾病脑中风后遗症的定义条件。如果首次重大疾病非脑中风后遗症，则本项责任终止。
疾病终末期保险金	若被保险人于本主险合同生效或最后一次复效之日起90日内（含第90日）因意外伤害以外的原因导致疾病且经专科医生明确诊断达到疾病终末期（见9.13），我们将向您返还本主险合同累计已交保险费（无息），同时本主险合同终止。若被保险人因意外伤害，或于本主险合同生效或最后一次复效之日起90日后因意外伤害以外的原因导致疾病且经专科医生明确诊断达到疾病终末期，我们将按以下三者中的最大者给付疾病终末期保险金，同时本主险合同终止。（一）被保险人经专科医生明确诊断达到疾病终末期时本主险合同的基本保险金额；（二）被保险人经专科医生明确诊断达到疾病终末期时本主险合同的现金价值；（三）被保险人经专科医生明确诊断达到疾病终末期时本主险合同累计已交保险费（无息）。
身故或全残保险金	若被保险人于本主险合同生效或者最后一次复效之日起90日内（含第90日）因意外伤害以外的原因导致身故或全残（见9.14）的，我们将向您返还本主险合同累计已交保险费（无息），同时本主险合同终止。若被保险人身故或全残时未满18周岁，且因意外伤害或于本主险合同生效或最后一次复效之日起90日后因意外伤害以外的原因导致身故或全残的，我们将按本主险合同累计已交保险费（无息）的2倍给付身故或全残保险金，同时本主险合同终止。若被保险人身故或全残时已满18周岁，且因意外伤害或于本主险合同生效或最后一次复效之日起90日后因意外伤害以外的原因导致身故或全残的，我们将按以下三者中的最大者给付身故或全残保险金，同时本主险合同终止。（一）被保险人身故或全残时本主险合同的基本保险金额；（二）被保险人身故或全残时本主险合同的现金价值；（三）被保险人身故或全残时本主险合同累计已交保险费（无息）。
轻症疾病豁免保险费	若被保险人因意外伤害，或于本主险合同生效或最后一次复效之日起90日后因意外伤害以外的原因导致疾病且经专科医生明确诊断初次罹患本主险合同约定的轻症疾病，我们将豁免本主险合同自轻症疾病确诊之日起的续期保险费，本主险合同继续有效。
中症疾病豁免保险费	若被保险人因意外伤害，或于本主险合同生效或最后一次复效之日起90日后因意外伤害以外的原因导致疾病且经专科医生明确诊断初次罹患本主险合同约定的中症疾病，我们将豁免本主险合同自中症疾病确诊之日起的续期保险费，本主险合同继续有效。
重大疾病豁免保险费	若被保险人因意外伤害，或于本主险合同生效或最后一次复效之日起90日后因意外伤害以外的原因导致疾病且经专科医生明确诊断初次罹患本主险合同约定的重大疾病，我们将豁免本主险合同自首次重大疾病确诊之日起的续期保险费，本主险合同继续有效。被豁免的本主险合同的保险费视同已交纳。在豁免保险费期间，我们不接受本主险合同基本保险金额及交费方式的变更。且经专科医生明确诊断初次罹患本主险合同约定的一种或多种轻症疾病、中症疾病或重大疾病，我们按轻症疾病保险金、中症疾病保险金或重大疾病保险金的规定，仅给付其中金额最高的一项保险金。二、若被保险人确诊本主险合同所定义的轻症疾病或中症疾病之前已经发生符合重大疾病保险金、疾病终末期保险金的保险事故而未申请理赔的，您在之后就上述以前发生的重大疾病保险金、疾病终末期保险金申请理赔时，我们将扣除已经给付的轻症疾病保险金或中症疾病保险金的金额。三、在任何情况下，我们仅给付本主险合同约定的重大疾病保险金、疾病终末期保险金和身故或全残保险金中的一项。若被保险人同时满足本主险合同约定的重大疾病保险金和全残保险金的给付条件，为了保障您和被保险人的利益，我们按照本主险合同约定的重大疾病保险责任（含重大疾病保险金、重大疾病豁免保险费）给付。
2.4责任免除	因下列情形之一，导致被保险人身故或全残，或罹患本主险合同约定的轻症疾病、中症疾病、重大疾病或达到疾病终末期的，我们不承担给付保险金及豁免保险费的责任。(一)投保人对被保险人的故意杀害、故意伤害；(二)被保险人故意自伤、故意犯罪或抗拒依法采取的刑事强制措施；(三)被保险人自本主险合同成立或者本主险合同效力恢复之日起2年内自杀，但被保险人自杀时为无民事行为能力人的除外；(四)被保险人服用、吸食或注射毒品（见9.15）；(五)被保险人酒后驾驶（见9.16），无合法有效驾驶证驾驶（见9.17）机动车（见9.18），或驾驶无有效行驶证（见9.19）的机动车；(六)战争、军事冲突、暴乱或武装叛乱；(七)核爆炸、核辐射或核污染；(八)遗传性疾病（见9.20），先天性畸形、变形或染色体异常（见9.21）。发生上述第（一）项情形导致被保险人身故或全残，或罹患本主险合同约定的轻症疾病、中症疾病、重大疾病或达到疾病终末期，本主险合同终止，您已交足2年以上保险费的，我们向被保险人或被保险人继承人退还本主险合同的现金价值。发生上述其他情形导致被保险人身故或全残，或罹患本主险合同约定的轻症疾病、中症疾病、重大疾病或达到疾病终末期，本主险合同终止，我们向您退还本主险合同的现金价值。
3.1受益人	一、您或者被保险人可以指定一人或多人为身故保险金的受益人。身故保险金受益人为多人时，可以确定受益顺序和受益份额；未确定受益份额的，各受益人按照相等份额享有受益权。二、您或者被保险人在被保险人身故前可以变更身故保险金受益人，但是需要书面通知我们。我们收到变更身故保险金受益人的书面通知后，将及时在保险单上批注或附贴批单。三、您在指定和变更身故保险金受益人时，必须经过被保险人或被保险人监护人同意。被保险人为无民事行为能力人或者限制民事行为能力人的，可以由其监护人指定和变更身故保险金受益人。四、被保险人身故后，遇有下列情形之一的，保险金作为被保险人的遗产，由我们依照中华人民共和国继承法的规定履行给付保险金的义务：(一)没有指定受益人，或者受益人指定不明无法确定的；(二)受益人先于被保险人身故，没有其他受益人的；(三)受益人依法丧失受益权或者放弃受益权，没有其他受益人的。五、受益人与被保险人在同一事件中身故，且不能确定身故顺序的，推定受益人身故在先。六、受益人故意造成被保险人身故或全残的，或者故意杀害被保险人未遂的，该受益人丧失受益权。七、除另有约定外，轻症疾病保险金、中症疾病保险金、重大疾病保险金、急性心肌梗塞二次给付保险金、脑中风后遗症二次给付保险金、疾病终末期保险金及全残保险金的受益人为被保险人本人。知我们。如果您、被保险人或其监护人、保险金申请人故意或者因重大过失未及时通知，致使保险事故的性质、原因、损失程度等难以确定的，我们对无法确定的部分，不承担给付保险金的责任，但我们通过其他途径已经及时知道或者应当及时知道保险事故发生或者虽未及时通知但不影响本公司确定保险事故的性质、原因、损失程度的除外。本主险合同项下的保险金申请人包括保险金受益人或其监护人，若保险金作为被保险人遗产时保险金申请人为被保险人的继承人或其监护人。
3.3保险金申请	一、在申请保险金时，请按照下列方式办理：
身故保险金申请	由身故保险金申请人填写理赔申请书，并须提供下列证明和资料：(一)保险合同；(二)身故保险金申请人的有效身份证件，当身故保险金申请人为监护人时，还需提供能够证明监护关系的证明文件；(三)国家卫生行政部门认定的医疗机构、公安部门或其他相关国家机构出具的被保险人的死亡证明；(四)所能提供的与确认保险事故性质、原因等有关的其他证明和资料。
全残保险金申请	由全残保险金申请人填写理赔申请书，并须提供下列证明和资料：(一)保险合同；(二)全残保险金申请人的有效身份证件，当全残保险金申请人为监护人时，还需提供能够证明监护关系的证明文件；(三)国家机关认可的有合法资质的伤残鉴定机构出具的被保险人残疾程度鉴定书；(四)被保险人因意外伤害导致全残的，需提供相关意外伤害的证明和资料；(五)所能提供的与确认保险事故性质、原因等有关的其他证明和资料。
疾病保险金及疾病豁免保险费申请	由保险金申请人填写理赔申请书，并须提供下列证明和资料：(一)保险合同；(二)保险金申请人的有效身份证件，当保险金申请人为监护人时，还需提供能够证明监护关系的证明文件；(三)医院（见9.22）出具的附有病理显微镜检查、血液检验及其他科学方法检验报告的被保险人疾病诊断证明；(四)所能提供的与确认保险事故性质、原因等有关的其他证明和资料。二、保险金作为被保险人遗产时，必须提供可证明合法继承权的相关文件。三、如果保险金申请人委托他人代为申请，则除上述证明和资料外，受托人还应提供授权委托书、受托人的有效身份证件等相关证明文件。四、以上证明和资料不完整的，我们将及时一次性书面通知保险金申请人补充提供有关的证明和资料。如被保险人罹患轻症疾病、中症疾病、重大疾病或达到疾病终末期，在申请本主险合同保险金时，我们有权根据实际情况，要求由我们指定或认可的医疗机构或我们指定的司法鉴定机构对被保险人进行身体检查、检验或对保险事故进行必要的鉴定。如被保险人拒绝检查、检验或鉴定，或因您、被保险人及其监护人或保险金申请人的原因导致前述检查、检验、鉴定无法进行，导致保险事故只能部分认定，或无法认定的，本公司对无法认定的部分，不承担给付保险金的责任。
3.4失踪处理	如果被保险人在本主险合同保险期间内且在本主险合同有效期内失踪且被法院宣告死亡，我们按本主险合同的约定给付相应的身故保险金，本主险合同终止。如果被保险人在宣告死亡后重新出现或者保险金申请人确知其没有死亡的，保险金申请人应于知道或应当知道后30日内向我们退还已给付的保险金，本主险合同的效力依法确定。出核定；情形复杂的，在30日内作出核定。对属于保险责任的，我们在与保险金申请人达成给付保险金的协议后10日内，履行给付保险金义务。二、我们未及时履行前款规定义务的，对属于保险责任的，除支付保险金外，应当赔偿保险金申请人因此受到的利息损失，利息按照我们确定的利率按单利计算，且我们确定的利率不低于中国人民银行公布的金融机构人民币活期存款基准利率。三、对不属于保险责任的，我们自作出核定之日起3日内向保险金申请人发出拒绝给付保险金通知书并说明理由。四、我们在收到理赔申请书及有关证明和资料之日起60日内，对给付保险金的数额不能确定的，根据已有证明和资料可以确定的数额先予支付；我们最终确定给付保险金的数额后，将支付相应的差额。
3.6诉讼时效	保险金申请人对我们请求给付保险金的诉讼时效期间为2年，自其知道或者应当知道保险事故发生之日起计算。
3.7司法鉴定	若被保险人身故，我们有权要求司法鉴定机构对保险事故进行鉴定。二、分期交纳保险费的，在交纳首期保险费后，您应当按约定的交费日期交纳其余各期的保险费。
4.2宽限期	一、如果您到期未交纳保险费，自保险单所约定的交费日的次日零时起60日为宽限期。宽限期内发生的保险事故，我们仍会承担保险责任，但在给付保险金时会扣除您欠交的保险费。二、如果您在宽限期结束之后仍未交纳保险费，除非本主险合同另有约定，否则本主险合同自宽限期满的次日零时起效力中止。
5.1现金价值	本主险合同保险单年度末的现金价值会在保险单上载明，保险单年度内的现金价值，您可以向我们咨询。
5.2保险单借款	一、在本主险合同保险期间内且在本主险合同有效期内，且在本主险合同生效满一年后，经我们同意，您可以凭保险单向我们申请借款。借款金额不得超过借款时本主险合同实际具有的现金价值扣除各项欠款后余额的80，每次借款期限最长不超过六个月，借款利率按我们当时确定的利率执行，并在借款协议中载明。二、借款本息应在借款到期前全部归还，若您到期未能足额偿还借款本息，则您所欠的借款本金及利息将作为新的借款本金计息。三、当未还借款本金及利息加上其他各项欠款达到本主险合同实际具有的现金价值时，本主险合同效力即行中止。
6.1效力中止	在本主险合同效力中止期间，我们不承担本主险合同项下的保险责任。
6.2效力恢复	一、本主险合同效力中止后2年内，您可以申请恢复本主险合同效力。经我们与您协商并达成协议，并向我们补交您全部欠交保险费及利息，如果您有未偿还的借款及借款利息，您需要同时向我们交清您的借款本金及借款利息，本主险合同自我们收到上述所有款项并核准之日零时起效力恢复。二、自本主险合同效力中止之日起满2年您和我们未达成协议的，我们有权解除本主险合同。我们解除本主险合同的，向您退还本主险合同效力中止日的现金价值。
7.1您解除合同的手续及风险	一、您在犹豫期后，可以书面通知要求解除本主险合同，并向我们提供下列证明和资料：（一）保险合同；（二）解除合同申请书；（三）您的有效身份证件。二、自我们收到解除合同申请书时起，本主险合同终止。我们在收到上述证明和资料之日起30日内向您退还本主险合同的现金价值。三、您在犹豫期后解除本主险合同会遭受一定损失。在被保险人或受益人已向您支付相当于本主险合同现金价值的款项并书面通知我们的情况下，您解除本主险合同应经被保险人或受益人同意。
8.1明确说明与如实告知	一、订立本主险合同时，我们应向您说明本主险合同的内容。二、对保险条款中免除我们责任的条款，我们在订立本主险合同时应当在投保单、保险单或者其他保险凭证上作出足以引起您注意的提示，并对该条款的内容以书面或者口头形式向您作出明确说明，未作提示或者明确说明的，该条款不产生效力。三、我们就您和被保险人的有关情况提出询问，您应当如实告知。四、如果您故意或者因重大过失未履行前款规定的如实告知义务，足以影响我们决定是否同意承保或者提高保险费率的，我们有权解除本主险合同。五、如果您故意不履行如实告知义务，对于本主险合同解除前发生的保险事故，我们不承担给付保险金的责任，并不退还保险费。六、如果您因重大过失未履行如实告知义务，对保险事故的发生有严重影响的，对于本主险合同解除前发生的保险事故，我们不承担给付保险金的责任，但应当退还保险费（无息）。七、我们在本主险合同订立时已经知道您未如实告知的情况的，我们不得解除本主险合同；发生保险事故的，我们承担给付保险金的责任。
8.2我们合同解除权的限制	前条规定的合同解除权，自我们知道有解除事由之日起，超过30日不行使而消灭。自本主险合同成立之日起超过2年的，我们不得解除合同；发生保险事故的，我们承担给付保险金的责任。
8.3年龄错误	您在申请投保时，应将与有效身份证件相符的被保险人的出生日期在投保书上填明，如果发生错误按照下列方式办理：（一）您申报的被保险人年龄不真实，并且其真实年龄不符合本主险合同约定投保年龄限制的，在保险事故发生之前我们有权解除本主险合同。我们行使合同解除权适用我们合同解除权的限制的规定。对于解除合同的，我们向您退还本主险合同的现金价值。（二）您申报的被保险人年龄不真实，致使您支付的保险费少于应交保险费的，我们有权更正并要求您补交保险费。若已经发生保险事故，在给付保险金时按实交保险费和应交保险费的比例给付。（三）您申报的被保险人年龄不真实，致使您支付的保险费多于应交保险费的，我们会将多收的保险费（无息）退还给您。
8.4未还款项	我们在给付各项保险金、退还现金价值或退还保险费时，如果您有欠交的保险费或其他未还清款项，我们会在扣除上述欠款后给付。变更本主险合同的有关内容。变更本主险合同的，由我们对保险合同批注或者附贴批单，或者由您与我们订立书面的变更协议。本主险合同约定的轻症疾病豁免保险费、中症疾病豁免保险费、重大疾病豁免保险费的保险责任对应的保险事故发生后，您不得变更本主险合同的基本保险金额、保险期间、交费期间等。以书面形式或双方认可的其他形式通知我们。若您未以书面形式或双方认可的其他形式通知我们，我们按本主险合同载明的最后住所或联系地址发送的有关通知，均视为已送达给您。
8.7全残的鉴定	若被保险人全残，在治疗结束后，由国家有关部门认可的具有合法资质的伤残鉴定机构进行鉴定。如果被保险人遭受意外伤害事故或被诊断患有疾病之日起180日内治疗仍未结束，按被保险人遭受意外伤害事故或被诊断患有疾病之日第180日的身体情况进行鉴定。
8.8效力终止	发生下列情况之一时，本主险合同效力终止：(一)您申请解除本主险合同；(二)被保险人身故或全残；(三)被保险人重大疾病保险金累计给付次数达到2次；(四)被保险人达到疾病终末期；(五)本主险合同有效期届满；(六)自本主险合同效力中止之日起满2年双方未达成复效协议；(七)其他导致本主险合同效力终止的情形。
8.9争议处理	本主险合同履行过程中，双方发生争议不能协商解决的，可以向被告住所地人民法院提起诉讼。
释义	
9.1周岁	指按有效身份证件中记载的出生日期计算的年龄，自出生之日起为零周岁，每经过一年增加一岁，不足一年的不计。官证、士兵证、居民户口簿（仅限未成年人）等证件。
9.3意外伤害	指遭受外来的、突发的、非本意的、非疾病的使身体受到伤害的客观事件，并以此客观事件为直接且单独原因导致被保险人身体蒙受伤害或者身故。
9.4专科医生	专科医生应当同时满足以下四项资格条件：（1）具有有效的中华人民共和国医师资格证书；（2）具有有效的中华人民共和国医师执业证书，并按期到相关部门登记注册；（3）具有有效的中华人民共和国主治医师或主治医师以上职称的医师职称证书；（4）在二级或二级以上医院的相应科室从事临床工作三年以上。
9.5罹患	指被保险人出现与本主险合同所约定的疾病相关的症状或体征，而该症状或体征已足以引起一般人士注意并去医院寻求医疗检查，且被诊断为本主险合同所约定的疾病或在其后发展为本主险合同约定的疾病。
9.6轻症疾病	指下面列出的40种轻症疾病
9.6.1极早期恶性肿瘤或恶性病变	指经组织病理学检查被明确诊断为下列恶性病变，并且接受了相应的治疗。（1）原位癌；（2）相当于Binet分期方案A期程度的慢性淋巴细胞白血病；（3）相当于AnnArbor分期方案I期程度的何杰金氏病；（4）皮肤癌（不包括恶性黑色素瘤及已发生转移的皮肤癌）；（5）TNM分期为T1N0M0期或更轻分期的前列腺癌。
9.6.2不典型心肌梗塞	指被临床诊断为急性心肌梗塞并接受了急性心肌梗塞治疗虽然未达到重大疾病急性心肌梗塞的给付标准，但满足下列全部条件：（1）肌钙蛋白有诊断意义的升高；（2）心电图有损伤性的ST段改变但未出现病理Q波。
9.6.3轻微脑中风后遗症	实际发生了脑血管的突发病变出现神经系统功能障碍表现，并接受住院治疗，头颅断层扫描（CT）、核磁共振（MRI）等影像学检查证实存在对应病灶，确诊为脑出血、脑栓塞或脑梗塞，在确诊180天后仍然遗留一肢或一肢以上肢体肌力III级或III级以下的运动功能障碍。因脑动脉瘤或脑血管瘤引起的轻微脑中风后遗症不在本保障范围内。
9.6.4微创冠状动脉搭桥手术（或称微创冠状动脉旁路移植术）	为纠正冠状动脉的狭窄或堵塞，而实际实施的冠状动脉旁路移植手术。手术通过微创开胸术（肋骨间小切口）进行，且诊断须由冠状动脉血管造影检查确诊狭窄或堵塞。微创冠状动脉绕道也包括锁孔冠脉搭桥手术。理赔必须满足所有以下条件：（1）血管造影显示至少两支冠状动脉狭窄超过50或一支冠状动脉狭窄70或更高；（2）手术须由心脏专科医师进行，并确认该手术是必要的。
9.6.5全身较小面积III度烧伤	指烧伤程度为度，且度烧伤面积达到全身体表面积的10或10以上，且未达到中症疾病中度面积III度烧伤和重大疾病严重III度烧伤的给付标准。体表面积根据中国新九分法计算。
9.6.6脑垂体瘤、脑囊肿	指经头颅断层扫描（CT）、核磁共振（MRI）或其他影像学检查被确诊为下列病变，并实际接受了手术或放射治疗。（1）脑垂体瘤；（2）脑囊肿。
9.6.7脑动脉瘤及脑血管瘤	指经头颅断层扫描（CT）、核磁共振（MRI）或其他影像学检查被确诊为脑动脉瘤、脑血管瘤，并实际接受了手术或放射治疗。大疾病双目失明的给付标准，但满足下列全部条件：（1）双眼中较好眼矫正视力低于0.1（采用国际标准视力表，如果使用其他视力表应进行换算）；（2）双眼中较好眼视野半径小于20度。申请理赔时，被保险人年龄必须在3周岁以上，并且须提供理赔当时的视力丧失诊断及检查证据。
9.6.9心脏瓣膜介入手术（非开胸手术）	为了治疗心脏瓣膜疾病，实际实施了非开胸的经胸壁打孔内镜手术或经皮经导管介入手术进行的心脏瓣膜置换或修复手术。因风湿热导致的心脏瓣膜疾病所致心脏瓣膜介入手术不在本保障范围。
9.6.10慢性肝功能衰竭失代偿早期	指因慢性肝脏疾病导致持续180天肝功能衰竭，须满足下列全部条件：（1）持续性黄疸，胆红素水平升高超过50umol/L；（2）蛋白质合成异常，白蛋白水平低于27g/L；（3）凝血酶原时间延长4秒；因酗酒或药物滥用导致的肝功能衰竭不在保障范围内。
9.6.11主动脉内手术（非开胸手术）	为了治疗主动脉疾病实际实施了经皮经导管进行的动脉内手术。主动脉指胸主动脉和腹主动脉，不包括胸主动脉和腹主动脉的分支血管。
9.6.12肝脏手术	指因疾病或意外事故实际实施的肝脏部分切除术，手术须有至少一个完整的肝叶切除。
9.6.13急性坏死性胰腺炎腹腔镜手术	指被保险人被确诊为急性坏死性胰腺炎，并实际接受了腹腔镜手术治疗，以进行坏死组织清除、坏死病灶切除或胰腺切除。因酗酒或饮酒过量所致的急性坏死性胰腺炎不在保障范围内。2000赫兹语音频率下，平均听阈大于70分贝，且经纯音听力测试、声导抗检测或听觉诱发电位检测等证实。被保险人申请理赔时年龄必须在三周岁以上，并且提供理赔当时的听力丧失诊断及检查证据。
9.6.15心脏起搏器或除颤器植入	因严重心律失常而确实已经实施植入永久性心脏起搏器或除颤器的手术。理赔时须提供完整病历资料及手术记录以证实此严重心律失常并不能以其他方法治疗，诊断及治疗均须本公司认可医院的专科医生认为是医疗必须的情况下进行。体外心脏电复律（心脏电除颤)、临时心脏起搏器及临时性埋藏式心脏复律除颤器安装除外。
9.6.16严重的骨质疏松	严重的骨质疏松，并因此而直接导致脊椎、骨盆、桡骨、尺骨、肱骨、胫骨、股骨骨折。骨质疏松的诊断必须由本公司认可医院合格的专科医生做出，并符合世界卫生组织关于骨质疏松的诊断标准。世界卫生组织关于骨质疏松的定义：骨密度检测，T值小于2.5。
9.6.17双侧睾丸切除术	指为治疗疾病实际接受了双侧睾丸完全切除手术。恶性肿瘤、变性手术、部分睾丸切除不在保障范围。
9.6.18双侧卵巢切除术	指为治疗疾病实际接受了经腹部切开或腹腔镜进行的双侧卵巢完全切除手术。恶性肿瘤、变性手术、部分卵巢切除不在保障范围。恶性肿瘤、肾脏部分切除手术和肾脏捐献引起的手术不在保障范围内。
9.6.20于颈动脉进行血管成形术或内膜切除术	指根据颈动脉造影检查结果，确诊一条或以上颈动脉存在严重狭窄性病变（至少一支血管管腔直径狭窄超过50以上）。本病须经国家机关认可的有合法资质的专科医生明确诊断，同时必须已经采取以下至少一种手术以减轻症状：（1）确实进行动脉内膜切除术；（2）确实进行血管介入治疗，例如血管成形术及/或进行植入支架或动脉粥样瘤清除手术。
9.6.21心包膜切除术因心包膜疾病导致已接受心包膜切除术或已进行任何需要心脏小切口技术的手	术。此手术必须在本公司认可医院内由心脏科医生认为是医疗上必需的情况下进行。
9.6.22硬脑膜下血肿手术	为清除或引流因意外导致的血肿，需于头部进行开颅或钻孔手术。开颅或钻孔手术必须在本公司认可医院内由专科医生认为是医疗必须的情况下进行。
9.6.23特定周围动脉指为治疗一条或者一条以上的下动脉狭窄而实施的血管介入治疗：疾病的血管介入治疗	（1）为下肢或者上肢供血的动脉；（2）肾动脉；（3）肠系膜动脉。须满足下列全部条件：（1）经血管造影术证实一条或者一条以上的上述动脉狭窄达到50或者以上；（2）对一条或者一条以上的上述动脉施行了血管介入治疗，如血管成形术及/或者进行植入支架或者动脉粥样样瘤清除手术。此诊断及治疗均须在本公司认可医院内由血管疾病的专科医生认为是医疗必须的情况下进行。
9.6.24植入腔静脉过滤器	指患者因反复肺栓塞发作，抗凝血疗法无效而接受手术植入腔静脉过滤器。此手术须在本公司认可医院内由专科医生认为是医疗必须的情况下进行。
9.6.25早期象皮病	指因丝虫感染导致淋巴管阻塞而造成身体组织出现严重淋巴水肿。此病症须经本公司认可医院的专科医生根据临床表现和微丝蚴的化验结果确诊。急性淋巴管炎或其它原因引起的淋巴水肿并不在保障范围取Ｋ篮痛固宸置诩に夭蛔悖造成性腺、甲状腺、肾上腺皮质功能减退。必须满足下列所有条件：（1）产后大出血休克病史；（2）严重腺垂体功能破坏，破坏程度95；（3）影像学检查显示脑垂体严重萎缩或消失；（4）实验室检查显示：4.1垂体前叶激素全面低下（包括生长激素、促甲状腺素、促肾上腺皮质激素、卵泡刺激素和黄体生成素）；和4.2性激素、甲状腺素、肾上腺皮质激素全面低下；（5）需要终身激素替代治疗以维持身体功能，持续服用各种替代激素超过一年。
9.6.27系统性红斑狼疮	本保障所指的系统性红斑狼疮必须符合下列所有理赔条件：（1）在下列5项情况中出现最少3项：1.1关节炎：非磨损性关节炎，需涉及两个或以上关节；1.2浆膜炎：胸膜炎或心包炎；1.3肾病：24小时尿蛋白定量达到0.5克，或尿液检查出现细胞管型；1.4血液学异常：溶血性贫血、白细胞减少、或血小板减少；1.5抗核抗体阳性、或抗dsDNA阳性，或抗Smith抗体阳性。（2）系统性红斑狼疮的诊断必须由本公司认可医院的风湿科或免疫系统专科医生确定。
9.6.28严重阻塞性睡眠呼吸暂停综合征	须由相关医学范畴的注册专科医生，经多导睡眠监测仪检查明确诊断为严重阻塞性睡眠呼吸暂停综合征(OSA)，并必须符合以下两项条件：（1）被保险人必须现正接受持续气道正压呼吸器(CPAP)之夜间治疗；（2）必须提供睡眠测试的文件证明，显示AHI30及夜间血氧饱和平均值85。而实施的脑外科手术不在保障范围内。因脑动脉瘤及脑血管瘤、脑垂体瘤、脑囊肿所引起的微创颅脑手术不在本保障范围内。达到中症疾病中度面部烧伤和重大疾病严重面部烧伤的给付标准。体表面积根据中国新九分法计算，面部总面积为全身体表面积的3。
9.6.31无颅内压增高的微小良性脑肿瘤	指直径小于2cm的脑的微小良性肿瘤，临床上无颅内压升高表现，无危及生命征象。微小良性脑肿瘤由头颅断层扫描（CT）、核磁共振检查（MRI）或正电子发射断层扫描（PET）等影像学检查证实，未实施开颅或微创切除肿瘤的手术治疗，仅接受了针对该脑肿瘤的放射治疗。脑垂体瘤、脑囊肿、脑动脉瘤及脑血管瘤不在本保障范围。
9.6.32风湿热导致的心脏瓣膜疾病	本保障须满足下列所有条件：（1）经由本公司认可的儿科专科医生根据已修订的Jones标准诊断证实罹患急性风湿热。（2）因风湿热所导致一个或以上最少轻度心脏瓣膜关闭不全或狭窄的心瓣损伤。有关诊断必须由本公司认可医院的的心脏专科医生根据心瓣功能的定量检查证实。捐献引起的手术不在保障范围内。
9.6.34头臂动脉型大动脉炎非开胸旁路移植手术	多发性大动脉炎（高安氏动脉炎）是一种发生在主动脉和其主要分支的慢性炎症性动脉疾病，表现为受累动脉狭窄或闭塞。头臂动脉型多发性大动脉炎是指多发性大动脉炎头臂动脉型（I型），又称为无脉症。被保险人被明确诊断为头臂动脉型多发性大动脉炎并且实际接受了非开胸的无名动脉（头臂干）、颈总动脉、锁骨下动脉旁路移植手术。经导管血管内手术不在本保障范围内。
9.6.35强直性脊柱炎的特定手术治疗	指诊断为强直性脊柱炎，且满足下列全部条件：（1）脊柱、髋、膝关节疼痛活动受限；（2）脊柱后凸畸形，髋、膝关节强直；（3）X线关节结构破坏征象；（4）实际实施了下列手术治疗的一项或多项：4.1脊柱截骨手术；4.2全髋关节置换手术；4.3膝关节置换手术。
9.6.36轻度脑炎或脑膜炎后遗症	指因患脑炎或脑膜炎导致的神经系统的永久功能障碍。神经系统永久性的功能障碍，指疾病确诊180天后，仍存在自主活动能力严重丧失，无法独立完成六项基本日常生活活动（见9.24）中的两项。
9.6.37轻度阿尔茨海默病	指因大脑进行性、不可逆性改变导致智能严重衰退或丧失，临床表现为明显的认知能力障碍、行为异常和社交能力减退，其日常生活必须持续受到他人监护。须由头颅断层扫描（CT）、核磁共振检查（MRI）或正电子发射断层扫描（PET）等影像学检查证实，且自主生活能力严重丧失，无法独立完成六项基本日常生活活动中的两项。神经官能症和精神疾病不在保障范围内。
9.6.38早期原发性心肌病	被诊断为原发性心肌病，并符合下列所有条件：（1）导致心室功能受损，其受损程度达到美国纽约心脏病学会心脏功能分级的第III级，或其同等级e，即：体力活动明显受限，休息时无症状，轻于日常的活动即可引起充血性心力衰竭的症状；（2）左室射血分数LVEF35；（3）原发性心肌病的诊断必须由本公司认可医院的心脏专科医生确认，并提供心脏超声检查结果报告。本保障范围内的心肌病包括扩张型心肌病、肥厚型心肌病及限制型心肌病。
9.6.39慢性肾功能障碍	指被保险人因双肾功能慢性不可逆性损害，达到肾功能衰竭期，诊断必须满足所有以下标准。（1）肾小球滤过率（GFR）25ml/min或肌酐清除率（Ccr）25ml/min；（2）血肌酐（Scr）5mg/dl或442umol/L；（3）持续180天。
9.6.40人工耳蜗植入术	指由于耳蜗的永久损害而实际实施了人工耳蜗植入手术。诊断须经专科医师确认在医学上是必要的，且在植入手术之前已经符合下列全部条件：（1）双耳持续12个月以上重度感音神经性耳聋；（2）使用相应的听力辅助设备效果不佳。
9.7初次罹患	指被保险人自出生之日起第一次出现而不是自本主险合同等待期后第一次出现与本主险合同所约定的疾病相关的症状或体征，而该症状或体征已足以引起一般人士注意并去医院寻求医疗检查，且被诊断为本主险合同所约定的疾病或在其后发展为本主险合同约定的疾病。
9.8中症疾病	指下面列出的25种中症疾病
9.8.1中度严重克隆氏病	克隆病是一种慢性肉芽肿性肠炎，具有特征性的克隆病病理组织学变化。诊断必须由病理检查结果证实。被保险人所患的克隆病必须已经造成瘘管形成，同时经专科医生以类固醇或免疫抑制剂连续治疗3个月以上，方符合赔偿条件。
9.8.2中度肠道疾病并发症	严重肠道疾病或外伤导致小肠损害并发症，本疾病须满足以下所有条件：（1）至少切除了二分之一小肠；（2）完全肠外营养支持二个月以上。因克隆氏病所致中度肠道疾病并发症不在本保障范围内。
9.8.3中度多发性硬化症	指被保险人因脑及脊髓内的脱髓鞘病变而出现神经系统多灶性（多发性）多时相（至少6个月以内有一次以上（不包含一次）的发作）的病变，须由计算机断层扫描（CT）、核磁共振检查（MRI）或正电子发射断层扫描（PET）等影像学检查证实，且已经造成自主生活能力严重丧失，无法独立完成六项基本日常生活活动中的两项，持续至少180天。
9.8.4中度肌营养不良症	指一组原发于肌肉的遗传性疾病，临床表现为与神经系统无关的肌肉无力和肌肉萎缩。须满足下列全部条件：（1）肌肉组织活检结果满足肌营养不良症的肌肉细胞变性、坏死等阳性改变；（2）自主生活能力严重丧失，无法独立完成六项基本日常生活活动中的两项。
9.8.5中度进行性核上神经麻痹症	指一种少见的神经系统变性疾病，以假球麻痹、垂直性核上性眼肌麻痹、锥体外系肌僵直、步态共济失调和轻度痴呆为主要临床特征。须满足自主生活能力严重丧失，无法独立完成六项基本日常生活活动中的两项。
9.8.6中度重症肌无力	指一种神经与肌肉接头部位传递障碍的自身免疫性疾病，临床特征是局部或全身肌肉于活动时易于疲劳无力，须经专科医生明确诊断，并满足下列全部条件：（1）经药物治疗或胸腺手术治疗一年以上无法控制病情，症状缓解、复发及恶化交替出现；（2）自主生活能力严重丧失，无法独立完成六项基本日常生活活动中的两项。诊180天后，仍遗留下列一种或一种以上障碍：（1）一肢或一肢以上肢体肌力III级或III级以下的运动功能障碍。（2）自主生活能力严重丧失，无法独立完成六项基本日常生活活动中的两项。该诊断必须由本公司认可医院的神经专科注册医生证实。并必须由适当的检查证明为结核性脊髓炎。
9.8.8中度强直性脊柱炎	是一种慢性全身性炎性疾病，主要侵犯脊柱导致脊柱畸形。必须明确诊断并且满足下列所有条件：（1）严重脊柱畸形；（2）自主生活能力严重丧失，无法独立完成六项基本日常生活活动中的两项。
9.8.9中度类风湿性关节炎	类风湿性关节炎为广泛分布的慢性进行性多关节病变，表现为关节严重变形，侵犯两个主要关节或关节组(如：双手（多手指）关节、双足（多足趾）关节、双腕关节、双膝关节和双髋关节)。且被保人满足至少180天无法独立完成六项基本日常生活活动中的两项。
9.8.10中度帕金森氏病	是一种中枢神经系统的退行性疾病，临床表现为震颤麻痹、共济失调等。必须满足下列全部条件：（1）药物治疗无法控制病情；（2）自主生活能力严重丧失，无法独立完成六项基本日常生活活动中的两项。继发性帕金森综合症不在保障范围内。
9.8.11中度严重脊髓灰质炎	脊髓灰质炎是由于脊髓灰质炎病毒感染所致的瘫痪性疾病，临床表现为运动功能损害或呼吸无力。脊髓灰质炎必须明确诊断。本保险合同仅对脊髓灰质炎造成的神经系统功能损害导致被保险人一肢或一肢以上肢体机能永久完全丧失的情况予以理赔。肢体机能永久完全丧失，指疾病确诊180天后，每肢三大关节中的至少一个大关节仍然完全僵硬，或不能随意识活动。
9.8.12早期运动神经元疾病	是一组中枢神经系统运动神经元的进行性变性疾病，进行性脊肌萎缩症、进行性延髓麻痹症、原发性侧索硬化症、肌萎缩性侧索硬化症。须满足自主生活能力严重丧失，无法独立完成六项基本日常生活活动中的两项。
9.8.13中度急性心肌梗塞	指被临床诊断为急性心肌梗塞并接受了急性心肌梗塞治疗，虽然未达到重大疾病急性心肌梗塞的给付标准，但须满足下列至少三项条件：（1）典型临床表现，例如急性胸痛；或不典型临床表现，例如上背部左侧、左肩、左臂内侧疼痛等；（2）心电图有损伤性的ST段改变但未出现病理Q波；（3）肌钙蛋白和肌酸激酶同工酶同时出现有诊断意义的升高；（4）超声心动图有局部室壁运动异常减弱的表现。
9.8.14糖尿病并发症引致的单足截除	因糖尿病引起的神经及血管病变累及足部，为了维持生命在本公司认可医院内已经进行了医疗必须的由足踝或以上位置的单足截除手术。切除多只脚趾或因任何其他原因引起的截除术不在保障范围内。
9.8.15全身中度面积III度烧伤	指烧伤程度为度，即全层皮肤烧伤，包括表皮、真皮和皮下组织，且度烧伤的面积达到全身体表面积的15或15以上，且未达到重大疾病严重III度烧伤的给付标准。体表面积根据中国新九分法计算。
9.8.16一肢缺失	指因疾病或意外伤害导致一个肢体自腕关节或踝关节近端（靠近躯干端）以上完全断离。因糖尿病并发症引致的单足截除不在本保障范围内。
9.8.17中度严重溃疡性结肠炎	溃疡性结肠炎是指伴有致命性电解质紊乱及肠道肿胀及有肠破裂的风险的大肠（结肠及直肠）粘膜炎症。须满足下列所有条件：（1）须经由内窥镜检查证实该疾病侵犯全部结肠及直肠，并经病理学组织切片检查证实为溃疡性结肠炎；（2）经专科注册医生以类固醇或免疫抑制剂连续治疗6个月。诊断及治疗均须在本公司认可的医院内由专科医师认为是医疗必须的情况下进行。
9.8.18中度脑中风后遗症	指因脑血管的突发病变引起脑血管出血、栓塞或者梗塞，并导致神经系统出现功能障碍表现，在确诊180天后神经系统功能障碍程度虽未达到重大疾病脑中风后遗症的给付标准，但仍遗留下列一种或者一种以上障碍：（1）一肢或一肢以上肢体肌力III级或III级以下的运动功能障碍；（2）自主生活能力严重丧失，无法独立完成六项基本日常生活活动中的两项。
9.8.19早期肝硬化	肝硬化须由专科医生明确诊断。必须由活检证实有再生的肝细胞结节和典型的肝组织纤维化。下列条件必须全部满足并至少持续一年：（1）持续性黄疸，胆红素水平升高超过50umol/L；（2）蛋白质合成异常，白蛋白水平低于27g/L；（3）异常凝血功能，凝血酶原时间超过正常上限的2倍或以上，或者国际正常化比率（INR）在2.0以上。
9.8.20可逆性再生障碍性贫血	指因急性可逆性的骨髓造血功能衰竭而导致贫血、中性粒细胞减少和血小板减少，必须由血液科医生的诊断，且病历资料显示接受了下列任一治疗：（1）骨髓刺激疗法至少一个月；（2）免疫抑制剂治疗至少一个月；（3）接受了骨髓移植。
9.8.21单眼失明	指因疾病或意外伤害导致单眼视力永久不可逆性丧失，须满足下列至少一项条件：（1）眼球缺失或摘除；（2）矫正视力低于0.02（采用国际标准视力表，如果使用其它视力表应进行换算）；（3）视野半径小于5度。
9.8.22单耳失聪	指因疾病或者意外伤害导致单耳听力永久不可逆性丧失，在500赫兹、1000赫兹和2000赫兹语音频率下，平均听阈大于90分贝，且经纯音听力测试、声导抗检测或者听觉诱发电位检测等证实。在0周岁至3周岁保单周年日期间，被保险人初患单耳失聪除外。
9.8.23角膜移植	指为增进视力或治疗某些角膜疾患，已经实施了异体的角膜移植手术。此手术必须在本公司认可医院内由专科医生认为是医疗必须的情况下进行。
9.8.24因肾上腺皮质腺瘤切除肾上腺	因肾上腺皮质腺瘤所导致的醛固酮分泌过多而产生的继发性恶性高血压而实际接受了肾上腺切除术治疗。此诊断及治疗均须在本公司认可医院内由专科医生认为是医疗必须的情况下进行。（登革热休克综合症即符合WHO登革热第级及第级）。出血性登革热的诊断必须由本公司认可医院的专科医生证实。非出血性登革热不在保障范围内。
9.9重大疾病	指下面列出的100种重大疾病
9.9.1恶性肿瘤	指恶性细胞不受控制的进行性增长和扩散，浸润和破坏周围正常组织，可以经血管、淋巴管和体腔扩散转移到身体其它部位的疾病。经病理学检查结果明确诊断，临床诊断属于世界卫生组织疾病和有关健康问题的国际统计分类（ICD10）的恶性肿瘤范畴。下列疾病不在保障范围内：（1）原位癌；（2）相当于Binet分期方案A期程度的慢性淋巴细胞白血病；（3）相当于AnnArbor分期方案I期程度的何杰金氏病；（4）皮肤癌（不包括恶性黑色素瘤及已发生转移的皮肤癌）；（5）TNM分期为T1N0M0期或更轻分期的前列腺癌；（6）感染艾滋病病毒或患艾滋病期间所患恶性肿瘤。三项条件：（1）典型临床表现，例如急性胸痛等；（2）新近的心电图改变提示急性心肌梗塞；（3）心肌酶或肌钙蛋白有诊断意义的升高，或呈符合急性心肌梗塞的动态性变化；（4）发病90天后，经检查证实左心室功能降低，如左心室射血分数低于50。功能障碍。神经系统永久性的功能障碍，指疾病确诊180天后，仍遗留下列一种或一种以上障碍：（1）一肢或一肢以上肢体机能完全丧失（见9.25）；（2）语言能力或咀嚼吞咽能力完全丧失（见9.26）；（3）自主生活能力完全丧失，无法独立完成六项基本日常生活活动中的三项或三项以上。
9.9.4重大器官移植术或造血干细胞移植术	重大器官移植术，指因相应器官功能衰竭，已经实施了肾脏、肝脏、心脏或肺脏的异体移植手术。造血干细胞移植术，指因造血功能损害或造血系统恶性肿瘤，已经实施了造血干细胞（包括骨髓造血干细胞、外周血造血干细胞和脐血造血干细胞）的异体移植手术。
9.9.5冠状动脉搭桥术（或称冠状动脉旁路移植术）	指为治疗严重的冠心病，实际实施了开胸进行的冠状动脉血管旁路移植的手术。冠状动脉支架植入术、心导管球囊扩张术、激光射频技术及其它非开胸的介入手术、腔镜手术不在保障范围内。
9.9.6终末期肾病（或称慢性肾功能衰竭尿毒症期）	指双肾功能慢性不可逆性衰竭，达到尿毒症期，经诊断后已经进行了至少90天的规律性透析治疗或实施了肾脏移植手术。端）以上完全性断离。
9.9.8急性或亚急性重症肝炎	指因肝炎病毒感染引起肝脏组织弥漫性坏死，导致急性肝功能衰竭，且经血清学或病毒学检查证实，并须满足下列全部条件：（1）重度黄疸或黄疸迅速加重；（2）肝性脑病；（3）B超或其它影像学检查显示肝脏体积急速萎缩；（4）肝功能指标进行性恶化。
9.9.9良性脑肿瘤	指脑的良性肿瘤，已经引起颅内压增高，临床表现为视神经乳头水肿、精神症状、癫痫及运动感觉障碍等，并危及生命。须由头颅断层扫描（CT）、核磁共振检查（MRI）或正电子发射断层扫描（PET）等影像学检查证实，并须满足下列至少一项条件：（1）实际实施了开颅进行的脑肿瘤完全切除或部分切除的手术；（2）实际实施了对脑肿瘤进行的放射治疗。脑垂体瘤、脑囊肿、脑血管性疾病不在保障范围内。
9.9.10慢性肝功能衰竭失代偿期	指因慢性肝脏疾病导致肝功能衰竭。须满足下列全部条件：（1）持续性黄疸；（2）腹水；（3）肝性脑病；（4）充血性脾肿大伴脾功能亢进或食管胃底静脉曲张。因酗酒或药物滥用导致的肝功能衰竭不在保障范围内。
9.9.11脑炎后遗症或脑膜炎后遗症	指因患脑炎或脑膜炎导致的神经系统永久性的功能障碍。神经系统永久性的功能障碍，指疾病确诊180天后，仍遗留下列一种或一种以上障碍：（1）一肢或一肢以上肢体机能完全丧失；（2）语言能力或咀嚼吞咽能力完全丧失；（3）自主生活能力完全丧失，无法独立完成六项基本日常生活活动中的三项或三项以上。
9.9.12深度昏迷	指因疾病或意外伤害导致意识丧失,对外界刺激和体内需求均无反应,昏迷程度按照格拉斯哥昏迷分级（Glasgowcomascale）结果为5分或5分以下，且已经持续使用呼吸机及其它生命维持系统96小时以上。因酗酒或药物滥用导致的深度昏迷不在保障范围内。
9.9.13双耳失聪	指因疾病或意外伤害导致双耳听力永久不可逆性丧失，在500赫兹、1000赫兹和2000赫兹语音频率下，平均听阈大于90分贝，且经纯音听力测试、声导抗检测或听觉诱发电位检测等证实。在0周岁至3周岁的保险单周年日期间，被保险人初患双耳失聪除外。申请理赔时，被保险人年龄必须在3周岁以上，并且须提供理赔当时的听力丧失诊断及检查证据。
9.9.14双目失明	指因疾病或意外伤害导致双眼视力永久不可逆性丧失，双眼中较好眼须满足下列至少一项条件：（1）眼球缺失或摘除；（2）矫正视力低于0.02（采用国际标准视力表，如果使用其它视力表应进行换算）；（3）视野半径小于5度。申请理赔时，被保险人年龄必须在3周岁以上，并且须提供理赔当时的视力丧失诊断及检查证据。
9.9.15瘫痪	指因疾病或意外伤害导致两肢或两肢以上肢体机能永久完全丧失。肢体机能永久完全丧失，指疾病确诊180天后或意外伤害发生180天后，每肢三大关节中的两大关节仍然完全僵硬，或不能随意识活动。
9.9.17严重阿尔茨海默病	指因大脑进行性、不可逆性改变导致智能严重衰退或丧失，临床表现为明显的认知能力障碍、行为异常和社交能力减退，其日常生活必须持续受到他人监护。须由头颅断层扫描（CT）、核磁共振检查（MRI）或正电子发射断层扫描（PET）等影像学检查证实，且自主生活能力完全丧失，无法独立完成六项基本日常生活活动中的三项或三项以上。神经官能症和精神疾病不在保障范围内。
9.9.18严重脑损伤	指因头部遭受机械性外力，引起脑重要部位损伤，导致神经系统永久性的功能障碍。须由头颅断层扫描（CT）、核磁共振检查（MRI）或正电子发射断层扫描（PET）等影像学检查证实。神经系统永久性的功能障碍，指脑损伤180天后，仍遗留下列一种或一种以上障碍：（1）一肢或一肢以上肢体机能完全丧失；（2）语言能力或咀嚼吞咽能力完全丧失；（3）自主生活能力完全丧失，无法独立完成六项基本日常生活活动中的三项或三项以上。下列全部条件：（1）药物治疗无法控制病情；（2）自主生活能力完全丧失，无法独立完成六项基本日常生活活动中的三项或三项以上。继发性帕金森综合征不在保障范围内。面积根据中国新九分法计算。
9.9.21严重原发性肺动脉高压	指不明原因的肺动脉压力持续性增高，进行性发展而导致的慢性疾病，已经造成永久不可逆性的体力活动能力受限，达到美国纽约心脏病学会心功能状态分级IV级，且静息状态下肺动脉平均压超过30mmHg。
9.9.22严重运动神经元病	是一组中枢神经系统运动神经元的进行性变性疾病，包括进行性脊肌萎缩症、进行性延髓麻痹症、原发性侧索硬化症、肌萎缩性侧索硬化症。须满足自主生活能力完全丧失，无法独立完成六项基本日常生活活动中的三项或三项以上的条件。全切除不受此时间限制），仍无法通过现有医疗手段恢复。精神心理因素所致的语言能力丧失不在保障范围内。在0周岁至3周岁的保险单周年日期间，被保险人初患语言能力丧失除外。
9.9.24重型再生障碍性贫血	指因骨髓造血功能慢性持续性衰竭导致的贫血、中性粒细胞减少及血小板减少。须满足下列全部条件：（1）骨髓穿刺检查或骨髓活检结果支持诊断；（2）外周血象须具备以下三项条件：2.1中性粒细胞绝对值0.510/L；2.2网织红细胞1；2.3血小板绝对值2010/L。
9.9.25主动脉手术	指为治疗主动脉疾病，实际实施了开胸或开腹进行的切除、置换、修补病损主动脉血管的手术。主动脉指胸主动脉和腹主动脉，不包括胸主动脉和腹主动脉的分支血管。动脉内血管成形术不在保障范围内。
9.9.26胰腺移植	指胰腺功能衰竭，已经实施了在全身麻醉下进行的胰腺的异体器官移植手术。单纯胰岛移植、部分胰腺组织或细胞的移植不在本保障范围内。
9.9.27埃博拉病毒感染	指埃博拉病毒感染导致的烈性传染病，并须满足下列全部条件：（1）实验室检查证实埃博拉病毒的存在；（2）从发病开始有超过30天的进行性感染症状。
9.9.28丝虫病所致象皮肿	指末期丝虫病，按国际淋巴学会分级为三度淋巴液肿，其临床表现为肢体非凹陷性水肿伴畸形增大、硬皮症和疣状增生。此病症须经本公司认可的专科医生根据临床表现和微丝蚴的化验结果确诊。
9.9.29主动脉夹层血肿	是指主动脉壁在受到某些病理因素的破坏后，高速、高压的主动脉血流将其内膜撕裂，以致主动脉腔内的血流通过主动脉内膜的破裂口进入主动脉内壁而形成血肿。被保险人需通过X线断层扫描（CT）、磁共振扫描（MRI）、磁共振血管检验法（MRA）或血管扫描等检查，并且实施了胸腹切开的主动脉内血管成形术。
9.9.30疯牛病	神经系统疾病及致命的成胶质状脑病，并有以下全部症状：（1）不能控制的肌肉痉挛及震颤；（2）逐渐痴呆；（3）小脑功能不良，共济失调；（4）手足徐动症。诊断必须由神经科专科医生基于以下检查报告作出：脑电图、脑脊液报告、电脑断层扫描(CT)及核磁共振(MRI)。
9.9.31破裂脑动脉瘤夹闭手术	指因脑动脉瘤破裂造成蛛网膜下腔出血，被保险人实际接受了在全麻下进行的开颅动脉夹闭手术脑动脉瘤（未破裂）预防性手术、颅骨打孔手术、动脉瘤栓塞手术、血管内手术及其他颅脑手术不在本保障范围内。
9.9.32经输血导致的人类免疫缺陷病毒感染	是指被保险人感染上人类免疫缺陷病毒并且符合下列所有条件：（1）在保障起始日或复效日之后，被保险人因治疗必需而接受输血，并且因输血而感染人类免疫缺陷病毒；（2）提供输血治疗的输血中心或医院出具该项输血感染属医疗责任事故的报告，或者法院终审裁定为医疗责任并且不准上诉；（3）提供输血治疗的输血中心或医院必须拥有合法经营执照；（4）受感染的被保险人不是血友病患者。在任何治愈艾滋病或阻止人类免疫缺陷病毒病毒作用的疗法被发现以后，或能防止艾滋病发生的医疗方法被研究出来以后，本保障将不再予以赔付。任何因其他传播方式（包括：性传播或静脉注射毒品）导致的人类免疫缺陷病毒感染不在本主险合同保障范围内。我们拥有获得使用被保险人的血液样本的权利和能够对这些样本进行独立检验的权利。
9.9.33原发性硬化性胆管炎	指一种胆汁淤积综合征，其特征是肝内、肝外胆道因纤维化性炎症逐渐狭窄，并最终导致完全阻塞而发展为肝硬化。本病须经内镜逆行胰胆管造影等影像学检查证实，并须满足下列全部条件：（1）总胆红素和直接胆红素同时升高，血清ALP200U/L；（2）持续性黄疸病史；（3）出现胆汁性肝硬化或门脉高压。因肿瘤或胆管损伤等继发性的硬化性胆管炎不在保障范围内。
9.9.34特发性慢性肾上腺皮质功能减退	因为自身免疫功能紊乱，使肾上腺组织逐渐受损，而需要长期接受糖皮质激素及肾上腺皮质激素替代疗法。该病必须经内分泌专科医生确诊，并有以下报告作为证据：（1）促肾上腺皮质激素(ACTH)刺激试验；（2）胰岛素血糖减少测试；（3）血浆促肾上腺皮质激素(ACTH)水平测定；（4）血浆肾素活性(PRA)测定。慢性肾上腺皮质功能减退只对由自身免疫功能紊乱引起的承担保险责任，其他原因引起的除外。
9.9.35系统性红斑狼疮（并发）III型或以上狼疮性肾炎	系统性红斑狼疮是由多种因素引起，累及多系统的自身免疫性疾病。其特点是生成自身抗体对抗多种自身抗原。多见于育龄妇女。本保险合同所指的系统性红斑狼疮仅限于累及肾脏（经肾脏活检确认的，符合WHO诊断标准定义III型至V型狼疮性肾炎）的系统性红斑狼疮。其他类型的红斑性狼疮，如盘状狼疮、仅累及血液及关节的狼疮不在本保险合同保障范围取１静”匦胗擅庖吆头缡科专家医师确诊。世界卫生组织（WHO）狼疮性肾炎分型：I型（微小病变型）镜下阴性，尿液正常II型（系膜病变型）中度蛋白尿，偶有尿沉渣改变III型（局灶及节段增生型）蛋白尿，尿沉渣改变IV型（弥漫增生型）急性肾炎伴有尿沉渣改变及或肾病综合征V型（膜型）肾病综合征或重度蛋白尿
9.9.36严重类风湿性关节炎	类风湿性关节炎为广泛分布的慢性进行性多关节病变，表现为关节严重变形，侵犯至少三个主要关节或关节组（如：双手（多手指）关节、双足（多足趾）关节、双腕关节、双膝关节和双髋关节）。类风湿性关节炎必须明确诊断并且已经达到类风湿性关节炎功能分级III级以上的功能障碍（关节活动严重限制，不能完成大部分的日常工作和活动）并且满足下列全部条件：（1）晨僵；（2）对称性关节炎；（3）类风湿性皮下结节；（4）类风湿因子滴度升高。
9.9.37重症急性坏死性筋膜炎	坏死性筋膜炎的诊断须同时符合下列要求：（1）符合坏死性筋膜炎的一般临床表现；（2）细菌培养检出致病菌；（3）出现广泛性肌肉及软组织坏死，并导致身体受影响部位永久完全失去功能。所谓永久完全失去功能是指受影响部位的全部功能完全丧失超过180天者。
9.9.38急性坏死性胰腺炎开腹手术	指被保险人因为急性出血坏死性胰腺炎已经接受了外科开腹手术治疗，以进行坏死组织清除、坏死病灶切除或胰腺切除。因饮酒所致的急性出血坏死性胰腺炎或经腹腔镜手术进行的治疗不在保障范围内。纤维化。诊断必须经活检及血清学检查证实，疾病必须是全身性，且须满足下列至少一项条件：（1）肺脏：肺部病变进而发展为肺间质纤维化和肺动脉高压；（2）心脏：心功能受损达到美国纽约心脏病学会心功能状态分级IV级；（3）肾脏：肾脏受损导致双肾功能慢性不可逆衰竭，达到尿毒症期。以下情况不在保障范围内：（1）局限性硬皮病（带状硬皮病或斑状损害）；（2）嗜酸性筋膜炎；（3）CREST综合征。
9.9.40慢性复发性胰腺炎	胰腺炎反复发作超过三次以上并导致胰腺功能紊乱和营养不良，需要接受酶替代治疗。诊断必须有消化科专科医生确认并且有内窥镜逆行胰胆管造影所证实。因酒精所致的慢性复发性胰腺炎除外。
9.9.41严重肌营养不良症	指一组原发于肌肉的遗传性疾病，临床表现为与神经系统无关的肌肉无力和肌肉萎缩。须满足下列全部条件：（1）肌肉组织活检结果满足肌营养不良症的肌肉细胞变性、坏死等阳性改变；（2）自主生活能力严重丧失，无法独立完成六项基本日常生活活动中的三项或三项以上。我们承担本项疾病责任不受本主险合同责任免除中遗传性疾病，先天性畸形、变形或染色体异常的限制。
9.9.42严重克隆病（Crohns病）	克隆病是一种慢性肉芽肿性肠炎，具有特征性的克隆病病理组织学变化。诊断必须由病理检查结果证实。被保险人所患的克隆病必须已经造成瘘管形成并伴有肠梗阻或肠穿孔。
9.9.43严重溃疡性结肠炎	溃疡性结肠炎是指伴有致命性电解质紊乱的急性暴发性溃疡性结肠炎，病变累及全结肠，表现为严重的血便和系统性症状体征，治疗通常采取全结肠切除和回肠造瘘术。溃疡性结肠炎必须根据组织病理学特点诊断，并且被保险人已经接受了结肠切除和回肠造瘘术。
9.9.44溶血性链球菌引起的坏疽	肢体或躯干的浅筋膜和/或深筋膜受到溶血性链球菌的感染，病情在短时间内急剧恶化，皮肤坏疽面积达到体表面积的10,已经立刻进行了手术及清创术。最后的诊断必须由微生物或病理学专家进行相关检查后证实。
9.9.45因职业关系导致的HIV感染	被保险人在其常规职业工作过程中遭遇外伤，或职业需要处理血液或其它体液时感染上人类免疫缺陷病毒（HIV）。必须满足下列全部条件：（1）感染必须是在被保险人正在从事其职业工作中发生，该职业必须属于下列限定职业范围内的职业；（2）血清转化必须出现在事故发生后的6个月以内；（3）必须提供被保险人在所报事故后发生的5天以内进行的检查报告，该报告必须显示被保险人血液人类免疫缺陷病毒（HIV）阴性和/或人类免疫缺陷病毒（HIV）抗体阴性；（4）必须在事故发生后的12个月内证实被保险人体内存在人类免疫缺陷病毒（HIV）或人类免疫缺陷病毒（HIV）抗体。限定职业：医生和牙科医生、护士、医院化验室工作人员、医院护工、医生助理和牙医助理、救护车工作人员、助产士、消防队员、警察、狱警。在任何治愈艾滋病或阻止人类免疫缺陷病毒病毒作用的疗法被发现以后，或能防止艾滋病发生的医疗方法被研究出来以后，本保障将不再予以赔付。
9.9.46脊髓灰质炎	是由于脊髓灰质炎病毒感染所致的瘫痪性疾病，临床表现为运动功能损害或呼吸无力。脊髓灰质炎必须明确诊断。本保险合同仅对脊髓灰质炎造成的神经系统功能损害导致被保险人一肢或一肢以上肢体机能永久完全丧失的情况予以理赔。肢体机能永久完全丧失，指疾病确诊180天后，每肢三大关节中的两大关节仍然完全僵硬，或不能随意识活动。
9.9.47植物人状态	指脑皮质广泛性坏死而导致对自身及周边的认知能力完全丧失,但脑干功能依然存在。必须由神经专科医生明确诊断,并有头颅断层扫描（CT），核磁共振检查（MRI）或正电子发射断层扫描（PET）等影像学检查证实。上述情况必须有至少一个月的病历记录加以证实。由于酗酒或滥用药物所致的植物人状态不在保障范围内。
9.9.48严重1型糖尿病	严重1型糖尿病为由于胰岛素分泌绝对不足引起的慢性血糖升高，且已经持续性地依赖外源性胰岛素维持180日以上。须经血胰岛素测定、血C肽测定或尿C肽测定，结果异常，并由内分泌科专科医生明确诊断。并须在本主险合同有效期内，满足下述至少1个条件：（1）已出现增殖性视网膜病变；（2）糖尿病肾病,血肌酐（SCR）707umol/L,且持续180日以上；（3）在本公司认可医院内已经进行了医疗必须的由足踝或以上位置的单足截除手术。
9.9.49非阿尔茨海默病所致严重痴呆	指因阿尔茨海默病以外的脑的器质性疾病造成脑功能衰竭导致永久不可逆性的严重痴呆，临床表现为明显的认知能力障碍、行为异常和社交能力减退。被保险人自主生活能力完全丧失，无法独立完成六项基本日常生活活动中的三项或三项以上，日常生活必须持续受到他人监护。导致痴呆的疾病必须明确诊断，并且由完整的临床、实验室和影像学检查结果证实。神经官能症和精神疾病不在保障范围内。
9.9.50严重冠状动脉粥样硬化性心脏病	指经冠状动脉造影检查明确诊断为主要血管严重狭窄性病变，须满足下列至少一项条件：（1）左冠状动脉主干和右冠状动脉中，一支血管管腔堵塞75以上，另一支血管管腔堵塞60以上；（2）左前降支、左旋支和右冠状动脉中，至少一支血管官腔堵塞75以上，其他两支血管官腔堵塞60以上。左前降支的分支血管、左旋支的分支血管及右冠状动脉的分支血管的狭窄不作为本保障的衡量指标。
9.9.51多发性硬化	被保险人因脑及脊髓内的脱髓鞘病变而出现神经系统多灶性（多发性）多时相（至少6个月以内有一次以上（不包含一次）的发作）的病变，须由计算机断层扫描（CT）、核磁共振检查（MRI）或正电子发射断层扫描（PET）等影像学检查证实，且已经造成自主生活能力完全丧失，无法独立完成六项基本日常生活活动中的三项或三项以上，持续至少180天。
9.9.52全身性（型）重症肌无力	是指一种神经与肌肉接头部位传递障碍的自身免疫性疾病，临床特征是局部或全身横纹肌于活动时易于疲劳无力，颅神经眼外肌最易累及，也可涉及呼吸肌、下肢近端肌群以至全身肌肉，须经本公司认可的神经科医师确诊。其诊断必须同时具有下列情况：（1）经药物、胸腺手术治疗一年以上无法控制病情，丧失正常工作能力；（2）出现眼睑下垂，或延髓肌受累引起的构音困难、进食呛咳,或由于肌无力累及延髓肌、呼吸肌而致机体呼吸功能不正常的危急状态即肌无力危象；（3）症状缓解、复发及恶化交替出现，临床接受新斯的明等抗胆碱酯酶药物治疗的病史。
9.9.53严重心肌病	指不明原因引起的一类心肌病变，包括原发性扩张型心肌病、原发性肥厚型心肌病及原发性限制型心肌病三种，病变必须已造成事实上心室功能障碍而出现明显的心功能衰竭（美国纽约心脏协会心功能分类标准心功能达四级），且有相关住院医疗记录显示四级心功能衰竭状态持续至少一百八十天。本病须经专科医生明确诊断。继发于全身性疾病或其它器官系统疾病造成的心肌病变除外。美国纽约心脏协会分类标准心功能四级是指有医院的医疗记录显示病人不能进行任何活动，休息时仍有心悸、呼吸困难等心力衰竭表现。
9.9.54慢性呼吸功能衰竭终末期肺病	慢性肺部疾病导致永久不可逆性的慢性呼吸功能衰竭。慢性呼吸功能衰竭必须明确诊断并满足下列全部条件：（1）动脉血氧分压（PaO2）50mmHg；（2）动脉血氧饱和度（SaO2）80；（3）因缺氧必须接受持续的输氧治疗。理赔时必须提供以上三项相应的证明文件或检查报告。
9.9.55严重心肌炎	指心肌局限性或弥漫性的急性或慢性炎症病变，导致心脏功能障碍，达到纽约心脏学会心功能分级状态分级IV级，且需持续至少90天。
9.9.56肺淋巴管肌瘤病	肺淋巴管肌瘤病是一种弥漫性肺部疾病，主要病理改变为肺间质、支气管、血管和淋巴管内出现未成熟的平滑肌异常增生，同时需满足下列全部条件：（1）经组织病理学诊断；（2）CT显示双肺弥漫性囊性改变；（3）休息时出现呼吸困难或并经本公司认可医院的专科医生认可有必要进行肺移植手术。
9.9.57侵蚀性葡萄胎（或称恶性葡萄胎）	该类疾病是指异常增生的绒毛组织浸润性生长浸入子宫肌层或转移至其他器官或组织的葡萄胎，经组织病理学检查明确诊断，并已经进行化疗或手术治疗的。流产手术不在本疾病保障范围内。
9.9.58度房室传导阻滞	指心房激动在房室交界区、房室束及其分支内发生阻滞，不能正常地传到心室的心脏传导性疾病，须满足下列所有条件：（1）心电图显示房室搏动彼此独立，心室率50次/分钟；（2）出现阿斯综合征或心力衰竭的表现；（3）必须持续性依赖心脏起搏器维持心脏正常功能，且已经放置心脏起搏器。
9.9.59感染性心内膜炎	指因细菌、真菌和其他微生物（如病毒、立克次体、衣原体、螺旋体等）直接感染而产生心瓣膜或心室壁内膜的炎症，须经心脏专科医生确诊，并符合以下所有条件：（1）血液培养测试结果为阳性，并至少符合以下条件之一：1.1微生物：在赘生物，栓塞的赘生物或心脏内脓肿培养或组织检查证实有微生物；1.2病理性病灶：组织检查证实赘生物或心脏内脓肿有活动性心内膜炎；1.3分别两次血液培养证实有典型的微生物且与心内膜炎符合；1.4持续血液培养证实有微生物阳性反应，且与心内膜炎符合。（2）心内膜炎引起中度心瓣膜关闭不全（指返流指数20或以上）或中度心瓣膜狭窄（指心瓣膜开口范围小于或等于正常的30）；（3）心内膜炎及心瓣膜损毁程度需经由心脏专科医生确诊。损害及/或神经功能恶化为特征。必须由本公司认可医院的专科注册医生通过肝脏活组织检查结果确定诊断并配合螯合剂治疗持续至少6个月。我们承担本项疾病责任不受本主险合同责任免除中遗传性疾病，先天性畸形、变形或染色体异常的限制。征的心脏病。须经呼吸专科医生确诊，且必须同时满足如下诊断标准：（1）左心房压力增高（不低于20个单位）；（2）肺血管阻力高于正常值3个单位（PulmonaryResistance）；（3）肺动脉血压不低于40毫米汞柱；（4）肺动脉楔压不低于6毫米汞柱；（5）右心室心脏舒张期末压力不低于8毫米汞柱；（6）右心室过度肥大、扩张，出现右心衰竭和呼吸困难。
9.9.62肾髓质囊性病肾髓质囊性病的诊断须同时符合下列要求：	（1）肾髓质有囊肿、肾小管萎缩及间质纤维化等病理改变；（2）肾功能衰竭；（3）诊断须由肾组织活检确定。我们承担本项疾病责任不受本主险合同责任免除中遗传性疾病，先天性畸形、变形或染色体异常的限制。
9.9.63严重继发性肺动脉高压	继发性肺动脉压力持续增高，导致右心室肥厚，已经造成永久不可逆性的体力活动能力受限，达到美国纽约心脏病学会心功能状态分级IV级。诊断需要由心脏科专科医生确诊，并且心导管检查报告显示静息状态下肺动脉平均压超过30mmHg。所有先天性心脏疾病直接或间接引起的肺动脉高压也不在保障责任范围内。
9.9.64进行性核上性麻痹	一种隐袭起病、逐渐加重的神经系统变性疾病。本疾病必须由本公司认可的医院的神经科专科医生确诊，并须满足下列所有条件：（1）步态共济失调；（2）对称性眼球垂直运动障碍；（3）假性球麻痹，表现为构音障碍和吞咽困难。
9.9.65失去一肢及一眼	因疾病或者意外伤害导致单眼视力丧失及任何一肢自腕关节或者踝关节近端（靠近躯干端）以上完全性断离。单眼视力丧失指单眼视力永久不可逆性丧失，患眼须满足下列至少一项条件：（1）眼球缺失或者摘除；（2）矫正视力低于0.02（采用国际标准视力表，如果使用其它视力表应进行换算）；（3）视野半径小于5度。
9.9.66嗜铬细胞瘤	是指肾上腺或肾上腺外嗜铬组织出现的以分过多的儿茶酚胺为表现的神经内分泌肿瘤，嗜铬细胞瘤必须由内分泌专科医生诊断，并且满足以下所有条件：（1）临床有高血压症候群表现；（2）已经实施了嗜铬细胞瘤切除手术。
9.9.67小肠移植	指因肠道疾病或意外伤害，已经实施了在全身麻醉下进行的小肠的异体器官移植手术。此手术必须由专科医生认为是医学上必需的情况下进行。
9.9.68颅脑手术	被保险人确已实施全麻下的开颅手术（不包括颅骨钻孔手术和经鼻蝶窦入颅手术）。因外伤而实施的脑外科手术不在保障范围之内。理赔时必须提供由神经外科医生出具的诊断书及手术报告。
9.9.69严重自身免疫性肝炎	自身免疫性肝炎是一种原因不明的慢性肝脏的坏死性炎性疾病，机体免疫机制被破坏，产生针对肝脏自身抗原的抗体导致自身免疫反应，从而破坏肝细胞造成肝脏炎症坏死，进而发展为肝硬化。必须满足所有以下条件：（1）高球蛋白血症；（2）血液中存在高水平的自身免疫抗体，如ANA（抗核抗体）、SMA（抗平滑肌抗体）、抗LKM1抗体或抗SLA/LP抗体；（3）肝脏活检证实免疫性肝炎；（4）临床已经出现腹水、食道静脉曲张和脾肿大等肝硬化表现。
9.9.70骨髓纤维化	原发性骨髓纤维化为原因不明的骨髓中成纤维细胞增殖，伴有髓外造血，表现为进行性贫血、脾肿大等症状。本疾病须根据骨髓的活组织检查和周围血象检查由我们认可的医院血液科专科医生明确诊断，并至少符合下列条件中的三项，且符合条件的状态持续180天及以上，并已经实际实施了针对此症的治疗：（1）血红蛋白100g/L；（2）白细胞计数2510/L；（3）外周血原始细胞1；（4）血小板计数10010/L。任何其它病因导致的继发性骨髓纤维化不在保障范围内。
9.9.71严重获得性或继发性肺泡蛋白质沉积症	因获得性或继发性原因或导致双肺肺泡和细支气管腔内充满不可溶性富磷脂蛋白的疾病。理赔时须满足下列所有条件：（1）支气管镜活检或开胸肺活检病理检查证实肺泡内充满有过碘酸雪夫（PAS）染色阳性的蛋白样物质；（2）被保险人因中重度呼吸困难或低氧血症而实际已进行全身麻醉下的全肺灌洗治疗。
9.9.72严重慢性缩窄性心包炎	由于慢性心包炎症导致心包脏层和壁层广泛瘢痕粘连、增厚和钙化，心包腔闭塞，形成一个纤维瘢痕外壳，使心脏和大血管根部受压，阻碍心脏的舒张。被保险人被明确诊断为慢性缩窄性心包炎且必须满足以下所有条件：（1）心功能衰竭达到美国纽约心脏病学会心功能状态分级IV级，并持续180天以上；（2）实际接受了以下任何一种手术路径的心包剥脱或心包切除手术；手术路径：胸骨正中切口；双侧前胸切口；左前胸肋间切口。经胸腔镜、胸壁打孔进行的手术、心包粘连松解手术不在保障范围内。日常生活活动中的五项或五项以上。被保险人的日常生活活动能力丧失必须是永久性的。在专科医生认为是医疗所需的情况下进。胆道闭锁并在保障范围内。动脉指胸主动脉及腹主动脉而非其旁支。诊断必须由专科医生及检验结果证实，检验包括电脑扫描，磁共振扫描及磁共振血管造影或心导管检查的证明，并有必要进行紧急修补手术。
9.9.76肌萎缩脊髓侧索硬化后遗症	以肌肉无力及萎缩为特征，并有以下情况作为证明：脊髓前角细胞功能失调、可见的肌肉颤动、痉挛、过度活跃之深层肌腱反射和外部足底反射、影响皮质脊髓束、构音障碍及吞咽困难。必须由我们认可的医院专科医生以适当的神经肌肉检查如肌电图（EMG）证实。本疾病必须导致严重的生理功能损坏（由被保险人永久性无法独立完成最少3项基本日常生活活动作为证明）。
9.9.77严重结核性脑膜炎	由结核杆菌引起的脑膜和脊膜的非化脓性炎症性疾病。需满足以下全部条件：（1）出现颅内压明显增高，表现头痛、呕吐和视乳头水肿；（2）出现部分性、全身性癫痫发作或癫痫持续状态；（3）昏睡或意识模糊；（4）视力减退、复视和面神经麻痹。
9.9.78严重肠道疾病并发症	严重肠道疾病或意外伤害导致小肠损害并发症，本疾病须满足以下所有条件：（1）至少切除了三分之二小肠；（2）完全肠外营养支持三个月以上。
9.9.79瑞氏综合症	瑞氏综合症是线粒体功能障碍性疾病。导致脂肪代谢障碍，引起短链脂肪酸、血氨升高，造成脑水肿。主要临床表现为急性发热、反复呕吐、惊厥及意识障碍等等。肝脏活检是确诊的重要手段。瑞氏综合征需由三级医院的儿科专科医生确诊，并符合下列所有条件：（1）有脑水肿和颅内压升高的脑脊液检查和影像学检查证据；（2）血氨超过正常值的3倍；（3）临床出现昏迷，病程至少达到疾病分期第3期。
9.9.80严重骨髓异常增生综合征	严重的骨髓异常增生综合征是指符合世界卫生组织（WHO）2008年分型方案中的难治性贫血细胞减少伴原始细胞增多1（RAEB1）、难治性贫血细胞减少伴原始细胞增多2（RAEB2）、MDS未分类（MDSU）、MDS伴单纯5q，且需满足下列所有条件：（1）由我们认可的医院中设有专门血液病专科的公立三级甲等医院，血液病专科的主治级别以上的医师确诊；（2）骨髓穿刺或骨髓活检结果支持诊断；（3）被保险人已持续接受一个月以上的化疗或已接受骨髓移植治疗。
9.9.82严重川崎病	是一种血管炎综合征，临床表现为急性发热，皮肤粘膜病损和淋巴结肿大。本病须经专科医生明确诊断，同时须由血管造影或超声心动图检查证实，满足下列至少一项条件：（1）伴有冠状动脉瘤，且冠状动脉瘤于最初急性发病后持续至少180天；（2）伴有冠状动脉瘤，且实际接受了对冠状动脉瘤进行的手术治疗。
9.9.83自体造血干细胞移植术	为治疗造血功能损害或造血系统恶性肿瘤，已经实施了造血干细胞（包括骨髓造血干细胞、外周血造血干细胞和脐血造血干细胞）的自体移植手术。该治疗须由专科医生认为在临床上是必需的。疱疹。经我们认可的医疗机构的专科医生确诊为患有手足口病，并伴有下列三项中的任意一项并发症：（1）有脑膜炎或脑炎并发症，且导致永久不可逆的神经系统损害或瘫痪；（2）有肺炎或肺水肿并发症，且导致永久不可逆的呼吸系统功能衰竭；（3）有心肌炎并发症，且导致心脏扩大或心力衰竭的临床表现及实验室检查证据。
9.9.85严重哮喘	指一种反复发作的严重支气管阻塞性疾病，经我们认可的专科医生确诊，且必须同时符合下列标准：（1）过去两年中曾因哮喘持续状态住院治疗，并提供完整住院记录；（2）因慢性过度换气导致胸廓畸形；（3）在家中需要医生处方的氧气治疗法；（4）持续日常服用口服类固醇激素治疗持续至少六个月。被保险人申请理赔时年龄必须在年满二十五周岁之前。型、III型、IV型。只保障III型或III型以上成骨不全的情形。其主要临床特点有：发展迟缓、多发性骨折、进行性脊柱后侧凸及听力损害。III型成骨不全的诊断必须根据身体检查，家族史，X线检查和皮肤活检报告资料确诊。我们承担本项疾病责任不受本主险合同责任免除中遗传性疾病、先天性畸形、变形或染色体异常的限制。
9.9.87器官移植导致的HIV感染	指因进行器官移植而感染上人类免疫缺陷病毒（HIV），且须满足下列全部条件：（1）在保障起始日或复效日之后，被保险人因治疗必需而实施器官移植，并且因器官移植而感染人类免疫缺陷病毒；（2）提供器官移植治疗的器官移植中心或医院出具该项器官移植感染，属于医疗责任事故的报告，或者法院终审裁定为医疗责任并且不准上诉；（3）提供器官移植治疗的器官移植中心或医院必须拥有合法经营执照。任何因其他传播方式（包括：性传播或静脉注射毒品）导致的HIV感染不在保障范围内。在任何治愈艾滋病或阻止人类免疫缺陷病毒病毒作用的疗法被发现以后，或能防止艾滋病发生的医疗方法被研究出来以后，本保障将不再予以赔付。
9.9.88进行性多灶性白质脑病	是一种亚急性脱髓鞘性脑病，常常发现于免疫缺陷的病人。必须由神经科专科医生根据脑组织活检确诊。
9.9.89脊髓小脑变性症	脊髓小脑变性症为一组以小脑萎缩和共济失调为主要临床特点的疾病。必须符合所有以下条件：（1）脊髓小脑变性症必须由医院诊断，并有以下证据支持：1.1影像学检查证实存在小脑萎缩；1.2临床表现存在共济失调、语言障碍和肌张力异常。（2）被保险人运动功能严重障碍，自主生活能力完全丧失，无法独立完成六项基本日常生活活动中的三项或三项以上。
9.9.90婴儿进行性脊肌萎缩症	是累及脊髓前角细胞及延髓运动核的神经元退行性变性病。在出生后两年内出现的脊髓和脑干颅神经前角细胞进行性机能障碍，伴随肌肉无力和延髓机能障碍。我们承担本项疾病责任不受本主险合同责任免除中遗传性疾病、先天性畸形、变形或染色体异常的限制。
9.9.91多处臂丛神经根性撕脱	由于疾病或意外导致两侧臂丛神经根性撕脱，所造成的双侧手臂感觉功能与运动功能完全永久性丧失。须由医院专科医生明确诊断，并且有电生理检查结果证实。
9.9.92严重甲型及乙型血友病	被保险人必须是患上严重甲型血友病（缺乏VIII凝血因子）或严重乙型血友病（缺乏IX凝血因子），而凝血因子VIII或凝血因子IX的活性水平少于百分之一。诊断必须由本公司认可医院的血液病专科医生确认。我们承担本项疾病责任不受本主险合同责任免除中遗传性疾病、先天性畸形、变形或染色体异常的限制。
9.9.93艾森门格综合征	因心脏病导致的严重肺动脉高压及右向左分流。诊断必须由心脏专科医生经超声心动图和心导管检查证实及需符合以下所有标准：（1）平均肺动脉压高于40mmHg；（2）肺血管阻力高于3mm/L/min（Wood单位）；（3）正常肺微血管楔压低于15mmHg。我们承担本项疾病责任不受本主险合同责任免除中遗传性疾病、先天性畸形、变形或染色体异常的限制。
9.9.94细菌性脑脊髓膜炎	指因脑膜炎双球菌感染引起脑脊髓膜化脓性病变，且导致永久性神经损害，持续180天以上，并且脑脊液检查显示脑膜炎双球菌阳性。永久性神经损害是指由细菌性脑脊髓膜炎引起的耳聋、失明、动眼神经麻痹、瘫痪、脑积水、智力或性情中度以上的损害，且上述症状持续180天以上仍无改善迹象。
9.9.95严重癫痫	本病的诊断须由神经科或儿科专科医生根据典型临床症状和脑电图及MRI、PET、CT等影相学检查做出。理赔时必须提供6个月以上的相关病历记录证明被保险人存在经抗癫痫药物治疗无效而反复发作的强直阵挛性发作或癫痫大发作，且已进行神经外科手术以治疗反复发作的癫痫。发热性惊厥以及没有全身性发作的失神发作（癫痫小发作）不在本保障范围内。
9.9.96疾病或外伤所致智力障碍	因严重头部创伤或疾病造成被保险人智力低常（智力低于常态）。根据智商（IQ），智力低常分为轻度（IQ5070）、中度（IQ3550）、重度（IQ2035）和极重度（IQ20）。智商的检测必须由我们认可的专职心理测验工作者进行，心理测验工作者必须持有由心理测量专业委员会资格认定书。根据被保险人年龄采用对应的智力量表如韦克斯勒智力量表（儿童智力量表或成人智力量表）。必须满足下列全部条件：（1）造成被保险人智力低常（智力低于常态）的严重头部创伤或疾病（以入院日期为准）发生在被保险人6周岁以后；（2）专科医师确诊被保险人由于严重头部创伤或疾病造成智力低常；（3）专职合格心理检测工作者适时做的心理检测证实被保险人智力低常（轻度、中度、重度或极重度）；（4）被保险人的智力低常自确认日起持续180天以上。
9.9.97重幼年型类风湿性关节炎	指为了治疗幼年型类风湿关节炎，实际实施了膝关节或髋关节置换手术。幼年型类风湿关节炎是一种儿童期发病的慢性关节炎，其特点为在高热和系统性病征出现数月后发生关节炎。被保险人疾病诊断时年龄必须在年满十八周岁之前。
9.9.98湿性年龄相关性黄斑变性	又称为新生血管性年龄相关性黄斑变性或渗出性年龄相关性黄斑变性，发生脉络膜新生血管（CNV）异常生长穿透玻璃膜进入视网膜，新生血管渗漏，渗出及出血。该病必须由荧光素眼底血管造影检查提示黄斑区新生血管形成，并且必须由医院的眼科专科医生确诊为湿性年龄相关性黄斑变性。被保险人申请理赔时须提供近3个月内视力改变显示病情恶化的相关检查报告、诊断证明及病历报告。
9.9.99脊柱裂	指脊椎或颅骨不完全闭合，导致脊髓脊膜突出，脑（脊）膜突出或脑膨出，合并大小便失禁，部分或完全性下肢瘫痪或畸形等神经学上的异常，但不包括由X线摄片发现的没有合并脊椎脊膜突出或脑（脊）膜突出的隐形脊椎裂。我们承担本项疾病责任不受本主险合同责任免除中遗传性疾病、先天性畸形、变形或染色体异常的限制。
9.9.100弥漫性血管内凝血	指血液凝固系统和纤溶系统的过度活动导致微血管血栓形成、血小板及凝血因子耗竭和严重出血，并且遗留永久不可逆的器官功能障碍。
9.10现金价值	指保险单所具有的价值，通常体现为解除合同时，根据精算原理计算的，由本公司退还的那部分金额。
9.13疾病终末期	被保险人被确诊为疾病的终末期状态。疾病已经无法以现有的医疗技术医治缓解，并且根据临床医学经验判断被保险人将于未来六个月内死亡。在家属及患者的要求和医师的同意下积极治疗已被放弃，所有治疗措施仅以减轻患者痛苦为目的。此疾病状态必须在被保险人生前已经确诊并且具有医疗证明文件和临床检查依据。
9.14全残	指下面列出的8种情形之一：（1）双目永久完全失明的；（注）（2）两上肢腕关节以上或两下肢踝关节以上缺失的；（3）一上肢腕关节以上及一下肢踝关节以上缺失的；（4）一目永久完全失明及一上肢腕关节以上缺失的；（5）一目永久完全失明及一下肢踝关节以上缺失的；（6）四肢关节机能永久完全丧失的；（注）（7）咀嚼、吞咽机能永久完全丧失的；（注）（8）中枢神经系统机能或胸、腹部脏器机能极度障碍，终身不能从事任何工作，为维持生命必要的日常生活活动，全需他人扶助的。（注）注：失明包括眼球缺失或摘除、或不能辨别明暗、或仅能辨别眼前手动者，最佳矫正视力低于国际标准视力表0.02，或视野半径小于5度，并由我们指定有资格的眼科医师出具医疗诊断证明。关节机能的丧失系指关节永久完全僵硬、或麻痹、或关节不能随意识活动。咀嚼、吞咽机能的丧失系指由于牙齿以外的原因引起器质障碍或机能障碍，以致不能做咀嚼、吞咽运动，除流质食物外不能摄取或吞咽的状态。为维持生命必要之日常生活活动，全需他人扶助系指食物摄取、大小便始末、穿脱衣服、起居、步行、入浴等，皆不能自己为之，需要他人帮助。所谓永久完全系指自意外伤害之日或疾病确诊之日起经过180天的治疗，机能仍然完全丧失，但眼球摘除等明显无法复原之情况，不在此限。
9.15毒品	指中华人民共和国刑法规定的鸦片、海洛因、甲基苯丙胺（冰毒）、吗啡、大麻、可卡因以及国家规定管制的其他能够使人形成瘾癖的麻醉药品和精神药品，但不包括由医生开具并遵医嘱使用的用于治疗疾病但含有毒品成分的处方药品。
9.16酒后驾驶	指经检测或鉴定，发生事故时车辆驾驶人员每百毫升血液中的酒精含量达到或超过一定的标准，公安机关交通管理部门依据中华人民共和国道路交通安全法的规定认定为饮酒后驾驶或醉酒后驾驶。
9.17无合法有效驾驶证驾驶	指下列情形之一：（1）未依法取得驾驶证资格；（2）驾驶证被依法扣留期间驾驶；（3）驾驶与驾驶证准驾车型不相符合的车辆；（4）持未经审验或者超过有效期限的驾驶证驾驶；（5）持学习驾驶证学习驾车时，无教练员随车指导，或不按指定时间、路线学习驾车；（6）公安交通管理部门认定的其他无有效驾驶证驾驶的情况。
9.18机动车	指以动力装置驱动或者牵引，上道路行驶的供人员乘用或者用于运送物品以及进行工程专项作业的轮式车辆，以交通管理部门认定为准。
9.19无有效行驶证指下列情形之一：	（1）机动车被依法注销登记的；（2）未依法按时进行或通过机动车安全技术检验。
9.20遗传性疾病	指生殖细胞或受精卵的遗传物质（染色体和基因）发生突变或畸变所引起的疾病，通常具有由亲代传至后代的垂直传递的特征。
9.21先天性畸形、变形或染色体异常	指被保险人出生时就具有的畸形、变形或染色体异常。先天性畸形、变形和染色体异常依照世界卫生组织疾病和有关健康问题的国际统计分类（ICD10）确定。
9.22医院	指国家卫生行政部门的医院等级分类中的二级或二级以上的医院，但不包括主要为康复、护理、疗养、戒酒、戒毒或相类似的医疗机构。
9.23永久不可逆	指自疾病确诊或意外伤害发生之日起，经过积极治疗180天后，仍无法通过现有医疗手段恢复。
9.24六项基本日常生活活动	六项基本日常生活活动是指：（1）穿衣：自己能够穿衣及脱衣；（2）移动：自己从一个房间到另一个房间；（3）行动：自己上下床或上下轮椅；（4）如厕：自己控制进行大小便；（5）进食：自己从已准备好的碗或碟中取食物放入口中；（6）洗澡：自己进行淋浴或盆浴。
9.25肢体机能完全丧失	指肢体的三大关节中的两大关节僵硬，或不能随意识活动。肢体是指包括肩关节的整个上肢或包括髋关节的整个下肢。
9.26语言能力或咀嚼吞咽能力完全丧失	语言能力完全丧失，指无法发出四种语音（包括口唇音、齿舌音、口盖音和喉头音）中的任何三种、或声带全部切除，或因大脑语言中枢受伤害而患失语症。咀嚼吞咽能力完全丧失，指因牙齿以外的原因导致器质障碍或机能障碍，以致不能作咀嚼吞咽运动，除流质食物外不能摄取或吞咽的状态。
