question	answer
1.1合同构成	本合同是您与我们约定保险权利义务关系的协议，包括本保险条款、保险单或其他保险凭证、投保单、与保险合同有关的投保文件、合法有效的声明、健康告知书、变更申请书、批注、批单及其他您与我们共同认可的书面协议。
1.2合同成立与生效	一、您提出保险申请、我们同意承保，本合同成立。二、本合同生效日在保险单上载明。保单年度、保单周年日、保险费约定支付日均以该日期计算。
1.3投保年龄	指投保时被保险人的年龄，投保年龄以周岁计算，本合同接受的投保年龄为0周岁（出生且出院满28日）至55周岁（含55周岁）。
1.4犹豫期	一、您收到本合同并签收之日起10日内（含第10日，保险监督管理机构对犹豫期天数另有规定的，从其规定）为犹豫期，在此期间请您仔细审阅本合同的各项内容，特别是责任免除条款、合同解除条款以及如实告知等内容。若您认为本合同与您的需求不相符，您可以在此期间提出解除本合同，我们将在扣除不超过10元的工本费后无息退还您所交纳的保险费。二、您在犹豫期内提出解除合同时需填写解除合同申请书，并提供保险合同及您的有效身份证件。自我们收到解除合同申请书时起，本合同即被解除，对于合同解除前发生的保险事故，我们不承担保险责任。
我们提供的保障	
2.1保险责任	在本合同有效期间内，我们按照以下约定承担保险责任：意外伤害以外的原因导致初次患本合同所列的轻症疾病，我们将按本合同基本保险金额的30给付轻症疾病保险金。每种轻症疾病只给付一次轻症疾病保险金，给付后该种轻症疾病保险金保险责任终止，本合同的轻症疾病保险金累计给付以三次为限。二、若被保险人因同一疾病原因、同次医疗行为或同次意外伤害事故导致初次患本合同所列的两种或两种以上轻症疾病，我们仅按一种轻症疾病给付轻症疾病保险金。三、若被保险人所患的轻症疾病同时符合本合同所列的轻症疾病定义和本合同所列的中症疾病定义的，我们仅承担给付中症疾病保险金的保险责任。四、若被保险人所患的轻症疾病同时符合本合同所列的轻症疾病定义和本合同所列的重大疾病定义的，我们仅承担给付重大疾病保险金的保险责任。意外伤害以外的原因导致初次患本合同所列的中症疾病，我们将按本合同基本保险金额的50给付中症疾病保险金。每种中症疾病只给付一次中症疾病保险金，给付后该种中症疾病保险金保险责任终止，本合同的中症疾病保险金累计给付以两次为限。二、若被保险人因同一疾病原因、同次医疗行为或同次意外伤害事故导致初次患本合同所列的两种或两种以上中症疾病，我们仅按一种中症疾病给付中症疾病保险金。三、若被保险人所患的中症疾病同时符合本合同所列的中症疾病定义和本合同所列的重大疾病定义的，我们仅承担给付重大疾病保险金的保险责任。本合同所列的重大疾病分为A、B、C、D、E五组，具体分组信息请见重大疾病险责任终止。本合同重大疾病保险金的累计给付次数以五次为限，当累计给付达到五次时，本合同终止。若被保险人因同一疾病原因、同次医疗行为或同次意外伤害事故导致初次患本合同所列的两种或两种以上重大疾病，我们仅按一种重大疾病给付重大疾病保险金。一、首次重大疾病保险金若被保险人于本合同生效或最后一次复效之日起90日内（含第90日）因意外伤害以外的原因导致初次患本合同所列的重大疾病的一种或多种，我们将按已交保险费给付重大疾病保险金，同时本合同终止。若被保险人因意外伤害或于本合同生效或最后一次复效之日起90日后因意外伤害以外的原因导致初次患本合同所列的重大疾病的一种或多种，我们将按以下三项的较大者给付首次重大疾病保险金，给付后该重大疾病所属组别的保险责任以及轻症疾病保险金、中症疾病保险金、身故保险金、全残保险金、疾病终末期保险金的保险责任均终止，同时本合同自首次重大疾病确诊之日起现金价值降为零，我们将继续承担其他组别重大疾病保险金的保险责任：(一)被保险人首次重大疾病确诊之日本合同的基本保险金额；(二)被保险人首次重大疾病确诊之日的已交保险费；(三)被保险人首次重大疾病确诊之日的现金价值。二、第二次重大疾病保险金我们给付首次重大疾病保险金后，若被保险人于首次重大疾病确诊之日起180日后初次患本合同所列的重大疾病中除首次重大疾病所属组别以外的其他组别中的重大疾病的一种或多种，我们将按本合同基本保险金额给付第二次重大疾病保险金，给付后该重大疾病所属组别的保险责任终止。三、第三次重大疾病保险金我们给付第二次重大疾病保险金后，若被保险人于第二次重大疾病确诊之日起180日后初次患本合同所列的重大疾病中除前述二次重大疾病所属组别以外的其他组别中的重大疾病的一种或多种，我们将按本合同基本保险金额给付第三次重大疾病保险金，给付后该重大疾病所属组别的保险责任终止。四、第四次重大疾病保险金我们给付第三次重大疾病保险金后，若被保险人于第三次重大疾病确诊之日起180日后初次患本合同所列的重大疾病中除前述三次重大疾病所属组别以外的其他组别中的重大疾病的一种或多种，我们将按本合同基本保险金额给付第四次重大疾病保险金，给付后该重大疾病所属组别的保险责任终止。五、第五次重大疾病保险金我们给付第四次重大疾病保险金后，若被保险人于第四次重大疾病确诊之日起180日后初次患本合同所列的重大疾病中除前述四次重大疾病所属组别以外的其他组别中的重大疾病的一种或多种，我们将按本合同基本保险金额给付第五次重大疾病保险金，给付后本合同终止。
身故保险金	一、若被保险人于本合同生效或最后一次复效之日起90日内（含第90日）因意外伤害以外的原因导致身故，我们将按已交保险费给付身故保险金，同时本合同终止。二、若被保险人于年满18周岁前，因意外伤害或于本合同生效或最后一次复效之日起90日后因意外伤害以外的原因导致身故，我们将按已交保险费的2倍给付身故保险金，同时本合同终止。三、若被保险人于年满18周岁后，因意外伤害或于本合同生效或最后一次复效之日起90日后因意外伤害以外的原因导致身故，我们将按以下三项的较大者给付身故保险金，同时本合同终止：(一)被保险人身故时本合同的基本保险金额；(二)被保险人身故时的已交保险费；(三)被保险人身故时的现金价值。
全残保险金	一、若被保险人于本合同生效或最后一次复效之日起90日内（含第90日）因意外伤害以外的原因导致全残，我们将按已交保险费给付全残保险金，同时本合同终止。二、若被保险人于年满18周岁前，因意外伤害或于本合同生效或最后一次复效之日起90日后因意外伤害以外的原因导致全残，我们将按已交保险费的2倍给付全残保险金，同时本合同终止。三、若被保险人于年满18周岁后，因意外伤害或于本合同生效或最后一次复效之日起90日后因意外伤害以外的原因导致全残，我们将按以下三项的较大者给付全残保险金，同时本合同终止：(一)被保险人全残时本合同的基本保险金额；(二)被保险人全残时的已交保险费；(三)被保险人全残时的现金价值。
疾病终末期保险金	一、若被保险人于本合同生效或最后一次复效之日起90日内（含第90日）因意外伤害以外的原因导致初次被专科医生确诊达到疾病终末期阶段，我们将按已交保险费给付疾病终末期保险金，同时本合同终止。二、若被保险人于年满18周岁前，因意外伤害或于本合同生效或最后一次复效之日起90日后因意外伤害以外的原因导致初次被专科医生确诊达到疾病终末期阶段，我们将按已交保险费的2倍给付疾病终末期保险金，同时本合同终止。三、若被保险人于年满18周岁后，因意外伤害或于本合同生效或最后一次复效之日起90日后因意外伤害以外的原因导致初次被专科医生确诊达到疾病终末期阶段，我们将按以下三项的较大者给付疾病终末期保险金，同时本合同终止：(一)被保险人疾病终末期确诊之日本合同的基本保险金额；(二)被保险人疾病终末期确诊之日的已交保险费；(三)被保险人疾病终末期确诊之日的现金价值。分期支付保险费的，已交保险费按照首次重大疾病或疾病终末期确诊之日、身故或全残时本合同的基本保险金额确定的年交保险费与交费年度数计算。一次性交纳保险费的，已交保险费按照首次重大疾病或疾病终末期确诊之日、身故或全残时本合同的基本保险金额确定的一次性交纳的保险费计算。重大疾病保险金、身故保险金、全残保险金与疾病终末期保险金，我们仅给付其中一项。
轻症疾病或中症疾病豁免保险费	若被保险人因意外伤害或于本合同生效或最后一次复效之日起90日后因意外伤害以外的原因导致初次患本合同所列的轻症疾病或中症疾病，我们将豁免本合同自轻症疾病或中症疾病确诊之日以后的各期保险费。
重大疾病豁免保险费	若被保险人因意外伤害或于本合同生效或最后一次复效之日起90日后因意外伤害以外的原因导致初次患本合同所列的重大疾病，我们将豁免本合同自重大疾病确诊之日以后的各期保险费。被豁免的保险费视为已交纳，同时本合同继续有效。
2.2责任免除	一、因下列情形之一在本合同有效期间内导致被保险人患本合同所列的轻症疾病、中症疾病、重大疾病、身故、全残或进入疾病终末期阶段的，我们不承担给付各项保险金的责任：(一)投保人对被保险人的故意杀害、故意伤害；(二)被保险人故意犯罪或抗拒依法采取的刑事强制措施；(三)被保险人自本合同成立或复效之日起2年内自杀，但被保险人自杀时为无民事行为能力人的除外；(四)被保险人主动吸食或注射毒品；(五)被保险人故意自伤；(六)被保险人酒后驾驶、无合法有效驾驶证驾驶或驾驶无有效行驶证的机动车；(七)被保险人感染艾滋病病毒或患艾滋病（本合同所列第33、34、85种重大疾病除外）；(八)战争、军事冲突、暴乱或武装叛乱；(九)核爆炸、核辐射或核污染；(十)遗传性疾病，先天性畸形、变形或染色体异常（本合同所列第86、97、98、100种重大疾病除外）。二、发生上述第（一）种情形导致被保险人患本合同所列的轻症疾病、中症疾病、重大疾病、全残或进入疾病终末期阶段的，本合同终止，您已交足2年以上保险费的，我们向被保险人退还本合同的现金价值。三、发生上述第（一）种情形导致被保险人身故的，本合同终止，您已交足2年以上保险费的，我们向被保险人的继承人退还本合同的现金价值。四、发生上述其他情形导致被保险人患本合同所列的轻症疾病、中症疾病、重大疾病、身故、全残或进入疾病终末期阶段的，本合同终止，我们向您退还本合同的现金价值。
2.3保险金额	本合同保险金额按本条款第2.1条规定，根据基本保险金额进行计算确定。基本保险金额由您和本公司在投保时约定，但须符合本公司当时的投保规定，约定的基本保险金额将在保险单上载明，若基本保险金额发生变更，则以变更后金额为准。
2.4未成年人身故保险金限制	为未成年子女投保的人身保险，因被保险人身故给付的保险金总和不得超过国务院保险监督管理机构规定的限额，身故给付的保险金额总和约定也不得超过前述限额。
2.5保险期间	本合同的保险期间为终身，自本合同生效日零时起算。
保险金的申请	
3.1受益人	一、您或被保险人可以指定一人或多人为身故保险金受益人。身故保险金受益人为多人时，可以确定受益顺序和受益份额；未确定受益顺序和受益份额的，各受益人按照相同顺序和相等份额享有受益权。二、被保险人为无民事行为能力人或限制民事行为能力人的，可以由其监护人指定受益人。三、您或被保险人可以变更身故保险金受益人并书面通知我们。我们收到变更受益人的书面通知后，在保险合同上批注或附贴批单。四、您在指定和变更身故保险金受益人时，必须经被保险人同意。五、被保险人身故后，遇有下列情形之一的，保险金作为被保险人的遗产，由我们依照中华人民共和国继承法的规定履行给付保险金的义务：(一)没有指定受益人，或者受益人指定不明无法确定的；(二)受益人先于被保险人身故，没有其他受益人的；(三)受益人依法丧失受益权或放弃受益权，没有其他受益人的。六、受益人与被保险人在同一事件中身故，且无法确定身故先后顺序的，推定受益人先于被保险人身故。七、受益人故意造成被保险人身故、伤残、疾病的，或故意杀害被保险人未遂的，该受益人丧失受益权。八、除另有约定外，轻症疾病保险金、中症疾病保险金、重大疾病保险金、全残保险金、疾病终末期保险金、轻症疾病或中症疾病豁免保险费和重大疾病豁免保险费的受益人为被保险人本人。
3.2保险事故通知	您、被保险人或受益人应于知道保险事故发生之日起10日内通知我们。若故意或因重大过失未及时通知，致使保险事故的性质、原因、损失程度等难以确定的，我们对无法确定的部分，不承担给付保险金的责任，但我们通过其他途径已经及时知道或应当及时知道保险事故发生或虽未及时通知但不影响我们确定保险事故的性质、原因、损失程度的除外。
3.3保险金申请	一、在本合同有效期间内，若发生符合本合同约定的保险金给付情形，根据发生情形的不同，受益人或被保险人的继承人可向我们申请给付保险金，但应当按照下列约定的程序和条件进行：
轻症疾病保险金、中症疾病保险金、重大疾病保险金、疾病终末期保险金、轻症疾病或中症疾病豁免保险费、重大疾病豁免保险费申请	申请轻症疾病保险金、中症疾病保险金、重大疾病保险金、疾病终末期保险金、轻症疾病或中症疾病豁免保险费、重大疾病豁免保险费的，申请人须填写保险金给付申请书，并向我们提供下列资料：(一)保险合同；(二)申请人的有效身份证件；(三)由医疗机构出具的可证明被保险人所患疾病的诊断证明和诊断所患疾病必需的检查报告；(四)所能提供的与确认保险事故的性质、原因、伤害程度等有关的其他资料。(一)保险合同；(二)申请人的有效身份证件；(三)国家卫生行政部门认定的医疗机构、公安部门或其他相关机构出具的被保险人死亡证明；(四)被保险人因意外伤害导致身故的，需提供相关意外伤害的证明和资料；(五)被保险人的户籍注销证明；(六)所能提供的与确认保险事故的性质、原因等有关的其他资料。(一)保险合同；(二)申请人的有效身份证件；(三)国家有关机关认可或具有合法资质的伤残鉴定机构出具的被保险人全残鉴定证明；(四)被保险人因意外伤害导致全残的，需提供相关意外伤害的证明和资料；(五)所能提供的与确认保险事故的性质、原因等有关的其他资料。二、保险金作为被保险人遗产时，申请人还须提供可证明合法继承权的相关权利文件。三、上述申请资料不完整的，我们将及时一次性通知申请人补充提供有关资料。
3.4宣告死亡的处理	一、若被保险人在本合同有效期间内被人民法院宣告死亡，保险金申请人在申请身故保险金时还须提供人民法院出具的具有最终法律效力的宣告死亡证明文件。二、被保险人在本合同有效期间内被人民法院宣告死亡的，我们将以人民法院出具的具有最终法律效力的宣告死亡证明文件所确定的死亡日期为被保险人身故日。三、若被保险人在人民法院宣告死亡之后重新出现或确知其没有死亡，保险金申请人应于知道或应当知道被保险人生还消息之日起30日内将已领取的身故保险金一次性返还给我们。
3.5保险金的给付	一、我们在收到保险金给付申请书及本合同约定的资料后，将在5日内作出核定；情形复杂的，在30日内作出核定。对属于保险责任的，我们在与受益人达成给付保险金的协议后10日内，履行给付保险金义务。二、我们未及时履行前款规定义务的，除支付保险金外，应当赔偿受益人因此受到的损失。三、对不属于保险责任的，我们自作出核定之日起3日内向受益人发出拒绝给付保险金通知书并说明理由。四、我们在收到保险金给付申请书及本合同约定的资料之日起60日内，对给付保险金的数额不能确定的，根据已有资料可以确定的数额先予支付；我们最终确定给付保险金的数额后，再给付相应的差额。
3.6诉讼时效	申请人向我们请求给付保险金的诉讼时效期间为2年，自其知道或应当知道保险事故发生之日起计算。
保险费的交纳	
4.1保险费的交纳	一、本合同的交费方式和交费期间由您和我们约定并在保险单上载明。二、分期支付保险费的，您在支付首期保险费后，应当在每个保险费约定支付日之前交纳当期保险费。
4.2宽限期	一、分期支付保险费的，您在支付首期保险费后，除本合同另有约定外，若您到期未支付保险费，自保险费约定支付日的次日零时起60日为宽限期。宽限期内发生的保险事故，我们仍会承担保险责任，但在给付保险金时会扣减您欠交的保险费。二、若您宽限期结束之后仍未支付保险费，则本合同自宽限期满的次日零时起中止。
现金价值权益	
5.1本合同现金价值	本合同保单年度末的现金价值会在保险合同中载明，保单年度之内的现金价值您可以向我们查询。
5.2保单质押借款	一、在本合同有效期间内，若本合同具有现金价值且不存在包含保单质押借款、自动垫交的保险费在内的未还款项及其利息，经您书面申请且我们审核同意后，您可在犹豫期后向我们办理保单质押借款。借款金额以借款时本合同现金价值的80为最高限额，每次借款期限最长不超过180日。二、借款及利息应在借款到期时一并归还。若您到期未能足额偿还借款及利息，则所欠的借款及利息将作为新的借款按我们最近一次宣布的利率计息。三、借款本息达到本合同及保险单内其他保险合同的现金价值时，本合同及保险单内其他保险合同终止，本合同及保险单内其他保险合同的现金价值将全部用于偿还借款本息。四、您申请保单质押借款须填写申请书及其他相关文件，并凭保险合同原件、您的有效身份证件办理。
5.3保险费自动垫交	一、您在投保时选择保险费自动垫交方式的，若分期交付的保险费超过宽限期仍未交付，且此时本合同及保险单内其他保险合同的现金价值扣除未还款项及其利息后的余额足以垫交当期保险费，我们将以本合同及保险单内其他保险合同的现金价值扣除未还款项及其利息后的余额自动垫交应交付的保险费，本合同及保险单内其他保险合同继续有效。垫交的保险费视作您从本公司的保单质押借款。若本合同及保险单内其他保险合同的现金价值扣除未还款项及其利息后的余额不足以垫交当期保险费，本合同及保险单内其他保险合同自宽限期满的次日零时起中止。二、在保险费自动垫交期间，若发生合同解除或保险金给付，我们将在您偿清垫交的保险费及利息后给付本合同及保险单内其他保险合同的现金价值或保险金。
合同中止和复效	
6.1合同中止	在本合同中止期间，我们不承担保险责任。
6.2合同复效	一、本合同中止后2年内，您可以申请恢复合同效力（即复效）。经我们与您协商并达成协议，自您补交复效时应交纳的全部保险费及其利息、借款本息和其他未还款项及其利息的次日零时起，本合同效力恢复。二、自本合同中止之日起满2年您和我们未达成协议的，我们有权解除合同。我们解除合同的，向您退还合同中止时的现金价值。
合同解除和变更	
7.1您解除合同的手续及风险	一、若您在犹豫期后申请解除本合同，请填写解除合同申请书并向我们提供下列资料：(一)保险合同；(二)您的有效身份证件。二、自我们收到解除合同申请书时起，本合同终止。我们自收到解除合同申请书之日起30日内退还本合同的现金价值。三、您在犹豫期后解除合同可能会遭受一定损失。
7.2合同变更	本合同生效后，您和我们可以协商变更本合同的内容。变更本合同时，您应当向我们提出变更合同的申请，经我们审核同意后，由我们在保险单或者其他保险凭证上批注或者附贴批单，或者由您和我们订立变更的书面协议。
7.3联系方式变更	为保障您的合法权益，您的住所、通讯地址或电话等联系方式变更时，请及时以书面形式或双方认可的其他形式通知我们。若您未以书面形式或双方认可的其他形式通知我们，我们按本合同载明的最后住所或通讯地址发送的有关通知，均视为已送达给您。
8.1明确说明	一、订立本合同时，我们应向您说明本合同的内容。二、对保险条款中免除我们责任的条款，我们在订立合同时应当在投保单、保险单或其他保险凭证上作出足以引起您注意的提示，并对该条款的内容以书面或口头形式向您作出明确说明，未作提示或明确说明的，该条款不产生效力。
8.2如实告知	一、我们就您和被保险人的有关情况提出询问的，您应当如实告知。二、若您故意或因重大过失未履行前款规定的如实告知义务，足以影响我们决定是否同意承保或提高保险费率的，我们有权解除本合同。三、若您故意不履行如实告知义务，对于本合同解除前发生的保险事故，我们不承担给付保险金的责任，并不退还保险费。四、若您因重大过失未履行如实告知义务，对保险事故的发生有严重影响的，对于本合同解除前发生的保险事故，我们不承担给付保险金的责任，但应当退还保险费。五、我们在合同订立时已经知道您未如实告知的情况的，我们不得解除合同；发生保险事故的，我们承担给付保险金的责任。
8.3本公司合同解除权的限制	前款约定的合同解除权，自我们知道有解除事由之日起，超过30日不行使而消灭。自本合同成立之日起超过2年的，我们不得解除合同；发生保险事故的，我们承担给付保险金的责任。
9.1年龄错误	您在申请投保时，应将与有效身份证件相符的被保险人的出生日期在投保单上填明，若发生错误按照下列方式办理：(一)您申报的被保险人年龄不真实，并且其真实年龄不符合本合同约定的投保年龄限制的，在保险事故发生之前我们有权解除合同，并向您退还本合同的现金价值。我们行使合同解除权适用本公司合同解除权的限制的约定。(二)您申报的被保险人年龄不真实，致使您实交保险费少于应交保险费的，我们有权更正并要求您补交保险费。若已经发生保险事故，我们在给付保险金时按实交保险费与应交保险费的比例给付。(三)您申报的被保险人年龄不真实，致使您实交保险费多于应交保险费的，我们会将多收的保险费退还给您。
9.2未还款项	我们在给付各项保险金、退还现金价值或返还保险费时，若您有欠交的保险费（包含宽限期内欠交的保险费）及其利息、未偿还的保单质押借款及其利息或其他未还款项及其利息，我们将在您偿清上述款项及相关利息后支付保险金、退还现金价值或返还保险费。
9.3争议处理	在本合同履行过程中发生任何争议，当事人应根据本合同约定选择下列两种方式之一予以解决：(一)因履行本合同发生的争议，由当事人协商解决，协商不成的，提交双方共同选定的仲裁委员会，按其当时有效的仲裁规则仲裁解决。(二)因履行本合同发生的争议，由当事人协商解决，协商不成的，依法向有管辖权的人民法院起诉。
释义	
10.1保单年度	从本合同生效日或保单周年日零时起至下一年度的保单周年日零时止为一个保单年度。
10.2保单周年日	指本合同生效日在合同生效后每年的对应日，不含本合同生效日当日。若当月没有对应的同一日，则以该月最后一日为对应日。若当月无对应的同一日，则以该月最后一日为对应日。
10.4周岁	指按法定身份证明文件中记载的出生日期计算的年龄，自出生之日起为零周岁，每经过一年增加一岁，不足一年的不计。
10.5有效身份证件	指由政府主管部门规定的证明其身份的证件，如：居民身份证、按规定可使用的有效护照、军官证、警官证、士兵证、户口簿等证件。
10.6意外伤害	指遭受外来的、突发的、非本意的、非疾病的客观事件直接致使身体受到的伤害。
10.7初次患本合同所列的轻症疾病、中症疾病、重大疾病	指被保险人患同时符合以下条件的疾病：（1）被保险人自出生后首次出现疾病之症状体征；（2）被保险人在本合同有效期间内首次出现疾病之症状体征并被确诊患该疾病；（3）该疾病之症状体征符合本合同的定义；（4）该疾病已在本合同中列明。对于被保险人在本合同生效日前出现的本合同所列的疾病之症状体征或所患的疾病，我们不承担保险责任。
10.8轻症疾病	指被保险人发生符合以下疾病定义所述条件的疾病（共35种），应当由专科医生明确诊断。
1.非危及生命的（极早期的）恶性病变	指被保险人生前经组织病理学检查被明确诊断为下列恶性病变，并且接受了相应的治疗。（1）原位癌；（2）相当于Binet分期方案A期程度的慢性淋巴细胞白血病；（3）相当于AnnArbor分期方案I期程度的何杰金氏病；（4）皮肤癌（不包括恶性黑色素瘤及已发生转移的皮肤癌）；（5）TNM分期为TNM期或更轻分期的前列腺癌。
2.冠状动脉介入手术	指被保险人为了治疗明显的冠状动脉狭窄性疾病，首次实际实施了冠状动脉球囊扩张成形术、冠状动脉支架植入术、冠状动脉粥肿斑块切除术或激光冠状动脉成形术。
3.轻微脑中风	指被保险人因非意外原因实际发生了脑血管的突发病变出现神经系统功能障碍表现，头颅断层扫描（CT）、核磁共振（MRI）等影像学检查证实存在对应病灶，确诊为脑出血、脑栓塞或脑梗塞，在确诊180天后仍然遗留一肢或一肢以上肢体肌力级或级以下的运动功能障碍。
4.心脏瓣膜介入手术	为了治疗心脏瓣膜疾病，被保险人实际接受了非开胸的经胸壁打孔内镜手术或经皮经导管介入手术进行的心脏瓣膜置换或修复手术。
5.脑垂体瘤、脑囊肿、脑动脉瘤及脑血管瘤	指被保险人经头颅断层扫描（CT）、核磁共振（MRI）或其他影像学检查被确诊为下列病变，并实际接受了手术或放射治疗。（1）脑垂体瘤；（2）脑囊肿；（3）脑动脉瘤、脑血管瘤。
6.主动脉内介入手术	指被保险人为了治疗主动脉疾病实际实施了经皮经导管进行的动脉内手术。主动脉指胸主动脉和腹主动脉，不包括胸主动脉和腹主动脉的分支血管。
7.单个肢体缺失	指因疾病或意外伤害导致一个肢体自腕关节或踝关节近端（靠近躯干端）以上完全性断离。肺脏部分切除手术和肺脏捐献引起的手术不在保障范围内。
9.肝脏手术	指因疾病或意外事故实际实施的肝脏部分切除术，手术须有至少一个完整的肝叶切除。因酒精或者滥用药物引致的疾病或者紊乱及/或者因捐赠肝脏而所需的肝脏手术均不在保障范围内。
10.人工耳蜗植入术	指由于耳蜗的永久损害而实际实施了人工耳蜗植入手术。诊断须经专科医师确认在医学上是必要的，且在植入手术之前已经符合下列全部条件：（1）双耳持续12个月以上重度感音神经性耳聋；（2）使用相应的听力辅助设备效果不佳。
11.胆道重建手术	指因疾病或胆道创伤导致接受涉及胆总管小肠吻合术的胆道重建手术。手术必须在专科医生认为是医疗所需的情况下进行。胆道闭锁并在保障范围内。
12.双侧卵巢或睾丸切除术	指为治疗疾病实际接受了经腹部切开或腹腔镜进行的双侧卵巢或睾丸完全切除手术。部分卵巢或睾丸切除不在保障范围。肾脏部分切除手术和肾脏捐献引起的手术不在保障范围内。
14.糖尿病导致脚趾截除	指因糖尿病引起的神经及血管病变累及足部，为了维持生命在本公司认可医院内已经进行了至少一个脚趾的截除术。
15.单耳失聪	指因疾病或者意外伤害导致单耳听力永久不可逆性丧失，在500赫兹、1000赫兹和2000赫兹语音频率下，平均听阈大于90分贝，且经纯音听力测试、声导抗检测或者听觉诱发电位检测等证实。被保险人在3周岁之前因疾病导致的单耳失聪不在保障范围内。因外伤而实施的脑外科手术不在保障范围内。
17.度房室传导阻滞已放置心脏起搏器	度房室传导指心房激动在房室交界区、房室束及其分支内发生阻滞，不能正常地传到心室的心脏传导性疾病须满足下列所有条件：（1）心电图显示房室搏动彼此独立，心室率50次/分钟；（2）出现阿斯综合征或心力衰竭的表现；（3）必须持续性依赖心脏起搏器维持心脏正常功能，且已经放置心脏起搏器。
18.于颈动脉进行血管成形术或内膜切除术	指根据颈动脉造影检查结果，确诊一条或以上颈动脉存在严重狭窄性病变（至少一支血管管腔直径减少50以上）。本病须经国家机关认可的有合法资质的专科医生明确诊断，同时必须已经采取以下手术以减轻症状：（1）确实进行动脉内膜切除术；或（2）确实进行血管介入治疗，例如血管成形术及/或进行植入支架或动脉粥样瘤清除手术。手术。手术必须在心脏科医生认为是医学上必需的情况下进行。
21.硬脑膜下血肿手术	为清除或引流因意外导致的血肿，需于头部进行开颅或钻孔手术。开颅或钻孔手术必须由专科医生认为是医学上必需的情况下进行。
22.严重阻塞性睡眠窒息症	须由相关医学范畴的注册专科医生，经多导睡眠监测仪检查明确诊断为严重阻塞性睡眠呼吸暂停综合征（OSA），并必须符合以下两项条件：（1）被保险人必须现正接受持续气道正压呼吸器（CPAP）之夜间治疗；（2）必须提供睡眠测试的文件证明，显示AHI30及夜间血氧饱和平均值85。
23.因意外毁容而施行的面部整形手术	指为修复意外伤害或暴力袭击造成的面部毁损，实际接受了在全身麻醉的情r下，由整形外科医生实施的对严重缺陷、缺失、损害或变形的面部形态和结构进行修复或重建的面部整形手术。面部整形手术必须在意外伤害后的180天内实施。因面部外伤后遗留的线条状瘢痕及色素沉着而施行的手术不在保障范围内。意外伤害必须满足下列全部条件：（1）由外在暴力引起并且造成表面可视性伤口和面部骨结构损害的，或面部皮肤度或全层意外烧伤；（2）是造成面部毁损的直接和独立的原因。
24.角膜移植	指为增进视力或治疗某些角膜疾患，已经实施了异体的角膜移植手术。此手术必须由专科医生认为是医学上必需的情况下进行。
25.可逆性再生障碍性贫血	指因急性可逆性的骨髓造血功能衰竭而导致贫血、中性粒细胞减少和血小板减少，必须由血液科医生的诊断，且病历资料显示接受了下列任一治疗：（1）骨髓刺激疗法至少1个月；（2）免疫抑制剂治疗至少1个月；（3）接受了骨髓移植。
26.特定周围动脉疾病的血管介入治疗	指为治疗一条或者一条以上的下列动脉狭窄而实施的血管介入治疗：（1）为下肢或者上肢供血的动脉；（2）肾动脉；（3）肠系膜动脉。须满足下列全部条件：（1）经血管造影术证实一条或者一条以上的上述动脉狭窄达到50或者以上；（2）对一条或者一条以上的上述动脉施行了血管介入治疗，如血管成形术及/或者进行植入支架或者动脉粥样样瘤清除手术。上述动脉疾病的诊断以及相关治疗的必要性必须由血管疾病的专科医生确定。
27.脑室腹腔分流术	指为治疗脑积水，将一组带单向阀门的分流装置置入体内,将脑脊液从脑室分流到腹腔中吸收，以降低脑脊液的压力。手术必须在神经外科专科医生证实植入分流器为医疗所需的情况下进行。未达到面部表面积的80。对于较小面积度烧伤、轻度面部烧伤、因意外毁容而施行的面部整形手术，若因同一原因导致上述两项或者两项以上情况同时满足，有关的烧伤或者手术在本合同内只能获赔偿一次。受肾上腺切除术。此项手术需由专科医生认定为处理恶性高血压的必要治疗行为。
30.早期象皮病	指因丝虫感染导致淋巴管阻塞而造成身体组织出现严重淋巴水肿。此病症须经本公司认可医院的专科医生根据临床表现和微丝蚴的化验结果确诊。急性淋巴管炎或其它原因引起的淋巴水肿并不在保障范围取＝撸ǖ歉锶刃菘俗酆现⒓捶合WHO登革热第级及第级）。出血性登革热的诊断必须由本公司认可医院的专科医生证实。非出血性登革热不在保障范围内。其形态及外观进行修复或者重建），同时必须由专科医生认为该面部毁容是需要接受住院治疗，及其后接受该手术，而对该面部毁容所进行的治疗亦是医疗所需。此手术必须在本公司认可医院内由专科医生认为是医疗上必需的情况下进行，并出具诊断证明。因纯粹整容原因、独立的牙齿修复、独立的鼻骨骨折或者独立的皮肤伤口所进行的手术均不受此保障。
33.不典型的急性心肌梗塞	指被临床诊断为急性心肌梗塞并接受了急性心肌梗塞治疗，虽然未达到重大疾病急性心肌梗塞的给付标准，但满足下列至少两项条件：（1）典型临床表现，例如急性胸痛等；（2）新近的心电图改变提示急性心肌梗塞；（3）心肌酶或肌钙蛋白有诊断意义的升高，或呈符合急性心肌梗塞的动态性变化；（4）发病90日后，经检查证实左心室功能降低，如左心室射血分数低于50。如被保险人同时或先后达到不典型的急性心肌梗塞、冠状动脉介入手术的赔付标准，我们仅赔付其中一项轻症疾病保险金，赔付后另外一个病种轻症责任终止。
34.严重的骨质疏松	严重的骨质疏松，并因此而直接导致脊椎、骨盆、桡骨、尺骨、肱骨、胫骨、股骨骨折。骨质疏松的诊断必须由本公司认可医院合格的专科医生做出，并符合世界卫生组织关于骨质疏松的诊断标准。世界卫生组织关于骨质疏松的定义：骨密度检测，T值小于2.5。
35.单眼失明	指因疾病或意外伤害导致单眼视力永久不可逆性丧失，须满足下列至少一项条件：（1）眼球缺失或摘除；（2）矫正视力低于0.02（采用国际标准视力表，如果使用其它视力表应进行换算）；（3）视野半径小于5度。
10.9中症疾病	指被保险人发生符合以下疾病定义所述条件的疾病（共20种），应当由专科医生明确诊断。
1.中度帕金森氏病	是一种中枢神经系统的退行性疾病，临床表现为震颤麻痹、共济失调等。必须满足下列全部条件：（1）药物治疗无法控制病情；（2）自主生活能力完全丧失，无法独立完成六项基本日常生活活动中的两项。继发性帕金森综合症不在保障范围内。
2.中度严重溃疡性结肠炎	溃疡性结肠炎是指伴有致命性电解质紊乱及肠道肿胀及有肠破裂的风险的大肠（结肠及直肠）粘膜炎症。须满足下列所有条件：（1）须经由内窥镜检查证实该疾病侵犯全部结肠及直肠，并经病理学组织切片检查证实为溃疡性结肠炎；（2）经专科注册医生以类固醇或免疫抑制剂连续治疗6个月。诊断及治疗均须在本公司认可的医院内由专科医师认为是医疗必须的情况下进行。
3.中度瘫痪	指因疾病或者意外伤害导致一肢或一肢以上肢体机能永久完全丧失，且未达到重大疾病瘫痪的给付标准。肢体机能永久完全丧失，指疾病确诊180天后或意外伤害发生180天后，每肢三大关节中的两大关节仍然完全僵硬，或不能随意识活动。
4.中度重症肌无力	指一种神经与肌肉接头部位传递障碍的自身免疫性疾病，临床特征是局部或全身肌肉于活动时易于疲劳无力，须经专科医生明确诊断，并满足下列全部条件：（1）经药物治疗或胸腺手术治疗一年以上无法控制病情，症状缓解、复发及恶化交替出现；（2）自主生活能力严重丧失，无法独立完成六项基本日常生活活动中的二项或二项以上。
5.中度进行性核上神经麻痹症	指一种少见的神经系统变性疾病，以假球麻痹、垂直性核上性眼肌麻痹、锥体外系肌僵直、步态共济失调和轻度痴呆为主要临床特征。须满足自主生活能力严重丧失，无法独立完成六项基本日常生活活动中的两项。
6.中度严重脊髓灰质炎	脊髓灰质炎是由于脊髓灰质炎病毒感染所致的瘫痪性疾病，临床表现为运动功能损害或呼吸无力。脊髓灰质炎必须明确诊断。本合同仅对脊髓灰质炎造成的神经系统功能损害导致被保险人一肢或一肢以上肢体机能永久完全丧失的情况予以理赔。肢体机能永久完全丧失，指疾病确诊180天后，每肢三大关节中的至少一个大关节仍然完全僵硬，或不能随意识活动。
7.中度严重克雅氏病	指一种罕见的主要发生在老年人之间的可传播的脑病。受感染的人可以有睡眠紊乱，个性改变，共济失调，失语症，视觉丧失，物理，肌肉萎缩，肌阵挛，进行性痴呆等症状。须满足自主生活能力严重丧失，无法独立完成六项基本日常生活活动中的两项。因人类生长激素治疗所致疾病不在保障范围内。
8.视力严重受损3周岁始理赔	
9.慢性肾功能损害	本合同是您与我们约定保险权利义务关系的协议，包括本保险条款、保险单或其他保险凭证、投保单、与保险合同有关的投保文件、合法有效的声明、健康告知书、变更申请书、批注、批单及其他您与我们共同认可的书面协议。一、您提出保险申请、我们同意承保，本合同成立。二、本合同生效日在保险单上载明。保单年度、保单周年日、保险费约定支付日均以该日期计算。指投保时被保险人的年龄，投保年龄以周岁计算，本合同接受的投保年龄为0周岁（出生且出院满28日）至55周岁（含55周岁）。一、您收到本合同并签收之日起10日内（含第10日，保险监督管理机构对犹豫期天数另有规定的，从其规定）为犹豫期，在此期间请您仔细审阅本合同的各项内容，特别是责任免除条款、合同解除条款以及如实告知等内容。若您认为本合同与您的需求不相符，您可以在此期间提出解除本合同，我们将在扣除不超过10元的工本费后无息退还您所交纳的保险费。二、您在犹豫期内提出解除合同时需填写解除合同申请书，并提供保险合同及您的有效身份证件。自我们收到解除合同申请书时起，本合同即被解除，对于合同解除前发生的保险事故，我们不承担保险责任。在本合同有效期间内，我们按照以下约定承担保险责任：意外伤害以外的原因导致初次患本合同所列的轻症疾病，我们将按本合同基本保险金额的30给付轻症疾病保险金。每种轻症疾病只给付一次轻症疾病保险金，给付后该种轻症疾病保险金保险责任终止，本合同的轻症疾病保险金累计给付以三次为限。二、若被保险人因同一疾病原因、同次医疗行为或同次意外伤害事故导致初次患本合同所列的两种或两种以上轻症疾病，我们仅按一种轻症疾病给付轻症疾病保险金。三、若被保险人所患的轻症疾病同时符合本合同所列的轻症疾病定义和本合同所列的中症疾病定义的，我们仅承担给付中症疾病保险金的保险责任。四、若被保险人所患的轻症疾病同时符合本合同所列的轻症疾病定义和本合同所列的重大疾病定义的，我们仅承担给付重大疾病保险金的保险责任。意外伤害以外的原因导致初次患本合同所列的中症疾病，我们将按本合同基本保险金额的50给付中症疾病保险金。每种中症疾病只给付一次中症疾病保险金，给付后该种中症疾病保险金保险责任终止，本合同的中症疾病保险金累计给付以两次为限。二、若被保险人因同一疾病原因、同次医疗行为或同次意外伤害事故导致初次患本合同所列的两种或两种以上中症疾病，我们仅按一种中症疾病给付中症疾病保险金。三、若被保险人所患的中症疾病同时符合本合同所列的中症疾病定义和本合同所列的重大疾病定义的，我们仅承担给付重大疾病保险金的保险责任。本合同所列的重大疾病分为A、B、C、D、E五组，具体分组信息请见重大疾病险责任终止。本合同重大疾病保险金的累计给付次数以五次为限，当累计给付达到五次时，本合同终止。若被保险人因同一疾病原因、同次医疗行为或同次意外伤害事故导致初次患本合同所列的两种或两种以上重大疾病，我们仅按一种重大疾病给付重大疾病保险金。一、首次重大疾病保险金若被保险人于本合同生效或最后一次复效之日起90日内（含第90日）因意外伤害以外的原因导致初次患本合同所列的重大疾病的一种或多种，我们将按已交保险费给付重大疾病保险金，同时本合同终止。若被保险人因意外伤害或于本合同生效或最后一次复效之日起90日后因意外伤害以外的原因导致初次患本合同所列的重大疾病的一种或多种，我们将按以下三项的较大者给付首次重大疾病保险金，给付后该重大疾病所属组别的保险责任以及轻症疾病保险金、中症疾病保险金、身故保险金、全残保险金、疾病终末期保险金的保险责任均终止，同时本合同自首次重大疾病确诊之日起现金价值降为零，我们将继续承担其他组别重大疾病保险金的保险责任：(一)被保险人首次重大疾病确诊之日本合同的基本保险金额；(二)被保险人首次重大疾病确诊之日的已交保险费；(三)被保险人首次重大疾病确诊之日的现金价值。二、第二次重大疾病保险金我们给付首次重大疾病保险金后，若被保险人于首次重大疾病确诊之日起180日后初次患本合同所列的重大疾病中除首次重大疾病所属组别以外的其他组别中的重大疾病的一种或多种，我们将按本合同基本保险金额给付第二次重大疾病保险金，给付后该重大疾病所属组别的保险责任终止。三、第三次重大疾病保险金我们给付第二次重大疾病保险金后，若被保险人于第二次重大疾病确诊之日起180日后初次患本合同所列的重大疾病中除前述二次重大疾病所属组别以外的其他组别中的重大疾病的一种或多种，我们将按本合同基本保险金额给付第三次重大疾病保险金，给付后该重大疾病所属组别的保险责任终止。四、第四次重大疾病保险金我们给付第三次重大疾病保险金后，若被保险人于第三次重大疾病确诊之日起180日后初次患本合同所列的重大疾病中除前述三次重大疾病所属组别以外的其他组别中的重大疾病的一种或多种，我们将按本合同基本保险金额给付第四次重大疾病保险金，给付后该重大疾病所属组别的保险责任终止。五、第五次重大疾病保险金我们给付第四次重大疾病保险金后，若被保险人于第四次重大疾病确诊之日起180日后初次患本合同所列的重大疾病中除前述四次重大疾病所属组别以外的其他组别中的重大疾病的一种或多种，我们将按本合同基本保险金额给付第五次重大疾病保险金，给付后本合同终止。一、若被保险人于本合同生效或最后一次复效之日起90日内（含第90日）因意外伤害以外的原因导致身故，我们将按已交保险费给付身故保险金，同时本合同终止。二、若被保险人于年满18周岁前，因意外伤害或于本合同生效或最后一次复效之日起90日后因意外伤害以外的原因导致身故，我们将按已交保险费的2倍给付身故保险金，同时本合同终止。三、若被保险人于年满18周岁后，因意外伤害或于本合同生效或最后一次复效之日起90日后因意外伤害以外的原因导致身故，我们将按以下三项的较大者给付身故保险金，同时本合同终止：(一)被保险人身故时本合同的基本保险金额；(二)被保险人身故时的已交保险费；(三)被保险人身故时的现金价值。一、若被保险人于本合同生效或最后一次复效之日起90日内（含第90日）因意外伤害以外的原因导致全残，我们将按已交保险费给付全残保险金，同时本合同终止。二、若被保险人于年满18周岁前，因意外伤害或于本合同生效或最后一次复效之日起90日后因意外伤害以外的原因导致全残，我们将按已交保险费的2倍给付全残保险金，同时本合同终止。三、若被保险人于年满18周岁后，因意外伤害或于本合同生效或最后一次复效之日起90日后因意外伤害以外的原因导致全残，我们将按以下三项的较大者给付全残保险金，同时本合同终止：(一)被保险人全残时本合同的基本保险金额；(二)被保险人全残时的已交保险费；(三)被保险人全残时的现金价值。一、若被保险人于本合同生效或最后一次复效之日起90日内（含第90日）因意外伤害以外的原因导致初次被专科医生确诊达到疾病终末期阶段，我们将按已交保险费给付疾病终末期保险金，同时本合同终止。二、若被保险人于年满18周岁前，因意外伤害或于本合同生效或最后一次复效之日起90日后因意外伤害以外的原因导致初次被专科医生确诊达到疾病终末期阶段，我们将按已交保险费的2倍给付疾病终末期保险金，同时本合同终止。三、若被保险人于年满18周岁后，因意外伤害或于本合同生效或最后一次复效之日起90日后因意外伤害以外的原因导致初次被专科医生确诊达到疾病终末期阶段，我们将按以下三项的较大者给付疾病终末期保险金，同时本合同终止：(一)被保险人疾病终末期确诊之日本合同的基本保险金额；(二)被保险人疾病终末期确诊之日的已交保险费；(三)被保险人疾病终末期确诊之日的现金价值。分期支付保险费的，已交保险费按照首次重大疾病或疾病终末期确诊之日、身故或全残时本合同的基本保险金额确定的年交保险费与交费年度数计算。一次性交纳保险费的，已交保险费按照首次重大疾病或疾病终末期确诊之日、身故或全残时本合同的基本保险金额确定的一次性交纳的保险费计算。重大疾病保险金、身故保险金、全残保险金与疾病终末期保险金，我们仅给付其中一项。若被保险人因意外伤害或于本合同生效或最后一次复效之日起90日后因意外伤害以外的原因导致初次患本合同所列的轻症疾病或中症疾病，我们将豁免本合同自轻症疾病或中症疾病确诊之日以后的各期保险费。若被保险人因意外伤害或于本合同生效或最后一次复效之日起90日后因意外伤害以外的原因导致初次患本合同所列的重大疾病，我们将豁免本合同自重大疾病确诊之日以后的各期保险费。被豁免的保险费视为已交纳，同时本合同继续有效。一、因下列情形之一在本合同有效期间内导致被保险人患本合同所列的轻症疾病、中症疾病、重大疾病、身故、全残或进入疾病终末期阶段的，我们不承担给付各项保险金的责任：(一)投保人对被保险人的故意杀害、故意伤害；(二)被保险人故意犯罪或抗拒依法采取的刑事强制措施；(三)被保险人自本合同成立或复效之日起2年内自杀，但被保险人自杀时为无民事行为能力人的除外；(四)被保险人主动吸食或注射毒品；(五)被保险人故意自伤；(六)被保险人酒后驾驶、无合法有效驾驶证驾驶或驾驶无有效行驶证的机动车；(七)被保险人感染艾滋病病毒或患艾滋病（本合同所列第33、34、85种重大疾病除外）；(八)战争、军事冲突、暴乱或武装叛乱；(九)核爆炸、核辐射或核污染；(十)遗传性疾病，先天性畸形、变形或染色体异常（本合同所列第86、97、98、100种重大疾病除外）。二、发生上述第（一）种情形导致被保险人患本合同所列的轻症疾病、中症疾病、重大疾病、全残或进入疾病终末期阶段的，本合同终止，您已交足2年以上保险费的，我们向被保险人退还本合同的现金价值。三、发生上述第（一）种情形导致被保险人身故的，本合同终止，您已交足2年以上保险费的，我们向被保险人的继承人退还本合同的现金价值。四、发生上述其他情形导致被保险人患本合同所列的轻症疾病、中症疾病、重大疾病、身故、全残或进入疾病终末期阶段的，本合同终止，我们向您退还本合同的现金价值。本合同保险金额按本条款第2.1条规定，根据基本保险金额进行计算确定。基本保险金额由您和本公司在投保时约定，但须符合本公司当时的投保规定，约定的基本保险金额将在保险单上载明，若基本保险金额发生变更，则以变更后金额为准。为未成年子女投保的人身保险，因被保险人身故给付的保险金总和不得超过国务院保险监督管理机构规定的限额，身故给付的保险金额总和约定也不得超过前述限额。本合同的保险期间为终身，自本合同生效日零时起算。一、您或被保险人可以指定一人或多人为身故保险金受益人。身故保险金受益人为多人时，可以确定受益顺序和受益份额；未确定受益顺序和受益份额的，各受益人按照相同顺序和相等份额享有受益权。二、被保险人为无民事行为能力人或限制民事行为能力人的，可以由其监护人指定受益人。三、您或被保险人可以变更身故保险金受益人并书面通知我们。我们收到变更受益人的书面通知后，在保险合同上批注或附贴批单。四、您在指定和变更身故保险金受益人时，必须经被保险人同意。五、被保险人身故后，遇有下列情形之一的，保险金作为被保险人的遗产，由我们依照中华人民共和国继承法的规定履行给付保险金的义务：(一)没有指定受益人，或者受益人指定不明无法确定的；(二)受益人先于被保险人身故，没有其他受益人的；(三)受益人依法丧失受益权或放弃受益权，没有其他受益人的。六、受益人与被保险人在同一事件中身故，且无法确定身故先后顺序的，推定受益人先于被保险人身故。七、受益人故意造成被保险人身故、伤残、疾病的，或故意杀害被保险人未遂的，该受益人丧失受益权。八、除另有约定外，轻症疾病保险金、中症疾病保险金、重大疾病保险金、全残保险金、疾病终末期保险金、轻症疾病或中症疾病豁免保险费和重大疾病豁免保险费的受益人为被保险人本人。您、被保险人或受益人应于知道保险事故发生之日起10日内通知我们。若故意或因重大过失未及时通知，致使保险事故的性质、原因、损失程度等难以确定的，我们对无法确定的部分，不承担给付保险金的责任，但我们通过其他途径已经及时知道或应当及时知道保险事故发生或虽未及时通知但不影响我们确定保险事故的性质、原因、损失程度的除外。一、在本合同有效期间内，若发生符合本合同约定的保险金给付情形，根据发生情形的不同，受益人或被保险人的继承人可向我们申请给付保险金，但应当按照下列约定的程序和条件进行：申请轻症疾病保险金、中症疾病保险金、重大疾病保险金、疾病终末期保险金、轻症疾病或中症疾病豁免保险费、重大疾病豁免保险费的，申请人须填写保险金给付申请书，并向我们提供下列资料：(一)保险合同；(二)申请人的有效身份证件；(三)由医疗机构出具的可证明被保险人所患疾病的诊断证明和诊断所患疾病必需的检查报告；(四)所能提供的与确认保险事故的性质、原因、伤害程度等有关的其他资料。(一)保险合同；(二)申请人的有效身份证件；(三)国家卫生行政部门认定的医疗机构、公安部门或其他相关机构出具的被保险人死亡证明；(四)被保险人因意外伤害导致身故的，需提供相关意外伤害的证明和资料；(五)被保险人的户籍注销证明；(六)所能提供的与确认保险事故的性质、原因等有关的其他资料。(一)保险合同；(二)申请人的有效身份证件；(三)国家有关机关认可或具有合法资质的伤残鉴定机构出具的被保险人全残鉴定证明；(四)被保险人因意外伤害导致全残的，需提供相关意外伤害的证明和资料；(五)所能提供的与确认保险事故的性质、原因等有关的其他资料。二、保险金作为被保险人遗产时，申请人还须提供可证明合法继承权的相关权利文件。三、上述申请资料不完整的，我们将及时一次性通知申请人补充提供有关资料。一、若被保险人在本合同有效期间内被人民法院宣告死亡，保险金申请人在申请身故保险金时还须提供人民法院出具的具有最终法律效力的宣告死亡证明文件。二、被保险人在本合同有效期间内被人民法院宣告死亡的，我们将以人民法院出具的具有最终法律效力的宣告死亡证明文件所确定的死亡日期为被保险人身故日。三、若被保险人在人民法院宣告死亡之后重新出现或确知其没有死亡，保险金申请人应于知道或应当知道被保险人生还消息之日起30日内将已领取的身故保险金一次性返还给我们。一、我们在收到保险金给付申请书及本合同约定的资料后，将在5日内作出核定；情形复杂的，在30日内作出核定。对属于保险责任的，我们在与受益人达成给付保险金的协议后10日内，履行给付保险金义务。二、我们未及时履行前款规定义务的，除支付保险金外，应当赔偿受益人因此受到的损失。三、对不属于保险责任的，我们自作出核定之日起3日内向受益人发出拒绝给付保险金通知书并说明理由。四、我们在收到保险金给付申请书及本合同约定的资料之日起60日内，对给付保险金的数额不能确定的，根据已有资料可以确定的数额先予支付；我们最终确定给付保险金的数额后，再给付相应的差额。申请人向我们请求给付保险金的诉讼时效期间为2年，自其知道或应当知道保险事故发生之日起计算。一、本合同的交费方式和交费期间由您和我们约定并在保险单上载明。二、分期支付保险费的，您在支付首期保险费后，应当在每个保险费约定支付日之前交纳当期保险费。一、分期支付保险费的，您在支付首期保险费后，除本合同另有约定外，若您到期未支付保险费，自保险费约定支付日的次日零时起60日为宽限期。宽限期内发生的保险事故，我们仍会承担保险责任，但在给付保险金时会扣减您欠交的保险费。二、若您宽限期结束之后仍未支付保险费，则本合同自宽限期满的次日零时起中止。本合同保单年度末的现金价值会在保险合同中载明，保单年度之内的现金价值您可以向我们查询。一、在本合同有效期间内，若本合同具有现金价值且不存在包含保单质押借款、自动垫交的保险费在内的未还款项及其利息，经您书面申请且我们审核同意后，您可在犹豫期后向我们办理保单质押借款。借款金额以借款时本合同现金价值的80为最高限额，每次借款期限最长不超过180日。二、借款及利息应在借款到期时一并归还。若您到期未能足额偿还借款及利息，则所欠的借款及利息将作为新的借款按我们最近一次宣布的利率计息。三、借款本息达到本合同及保险单内其他保险合同的现金价值时，本合同及保险单内其他保险合同终止，本合同及保险单内其他保险合同的现金价值将全部用于偿还借款本息。四、您申请保单质押借款须填写申请书及其他相关文件，并凭保险合同原件、您的有效身份证件办理。一、您在投保时选择保险费自动垫交方式的，若分期交付的保险费超过宽限期仍未交付，且此时本合同及保险单内其他保险合同的现金价值扣除未还款项及其利息后的余额足以垫交当期保险费，我们将以本合同及保险单内其他保险合同的现金价值扣除未还款项及其利息后的余额自动垫交应交付的保险费，本合同及保险单内其他保险合同继续有效。垫交的保险费视作您从本公司的保单质押借款。若本合同及保险单内其他保险合同的现金价值扣除未还款项及其利息后的余额不足以垫交当期保险费，本合同及保险单内其他保险合同自宽限期满的次日零时起中止。二、在保险费自动垫交期间，若发生合同解除或保险金给付，我们将在您偿清垫交的保险费及利息后给付本合同及保险单内其他保险合同的现金价值或保险金。在本合同中止期间，我们不承担保险责任。一、本合同中止后2年内，您可以申请恢复合同效力（即复效）。经我们与您协商并达成协议，自您补交复效时应交纳的全部保险费及其利息、借款本息和其他未还款项及其利息的次日零时起，本合同效力恢复。二、自本合同中止之日起满2年您和我们未达成协议的，我们有权解除合同。我们解除合同的，向您退还合同中止时的现金价值。一、若您在犹豫期后申请解除本合同，请填写解除合同申请书并向我们提供下列资料：(一)保险合同；(二)您的有效身份证件。二、自我们收到解除合同申请书时起，本合同终止。我们自收到解除合同申请书之日起30日内退还本合同的现金价值。三、您在犹豫期后解除合同可能会遭受一定损失。本合同生效后，您和我们可以协商变更本合同的内容。变更本合同时，您应当向我们提出变更合同的申请，经我们审核同意后，由我们在保险单或者其他保险凭证上批注或者附贴批单，或者由您和我们订立变更的书面协议。为保障您的合法权益，您的住所、通讯地址或电话等联系方式变更时，请及时以书面形式或双方认可的其他形式通知我们。若您未以书面形式或双方认可的其他形式通知我们，我们按本合同载明的最后住所或通讯地址发送的有关通知，均视为已送达给您。一、订立本合同时，我们应向您说明本合同的内容。二、对保险条款中免除我们责任的条款，我们在订立合同时应当在投保单、保险单或其他保险凭证上作出足以引起您注意的提示，并对该条款的内容以书面或口头形式向您作出明确说明，未作提示或明确说明的，该条款不产生效力。一、我们就您和被保险人的有关情况提出询问的，您应当如实告知。二、若您故意或因重大过失未履行前款规定的如实告知义务，足以影响我们决定是否同意承保或提高保险费率的，我们有权解除本合同。三、若您故意不履行如实告知义务，对于本合同解除前发生的保险事故，我们不承担给付保险金的责任，并不退还保险费。四、若您因重大过失未履行如实告知义务，对保险事故的发生有严重影响的，对于本合同解除前发生的保险事故，我们不承担给付保险金的责任，但应当退还保险费。五、我们在合同订立时已经知道您未如实告知的情况的，我们不得解除合同；发生保险事故的，我们承担给付保险金的责任。前款约定的合同解除权，自我们知道有解除事由之日起，超过30日不行使而消灭。自本合同成立之日起超过2年的，我们不得解除合同；发生保险事故的，我们承担给付保险金的责任。您在申请投保时，应将与有效身份证件相符的被保险人的出生日期在投保单上填明，若发生错误按照下列方式办理：(一)您申报的被保险人年龄不真实，并且其真实年龄不符合本合同约定的投保年龄限制的，在保险事故发生之前我们有权解除合同，并向您退还本合同的现金价值。我们行使合同解除权适用本公司合同解除权的限制的约定。(二)您申报的被保险人年龄不真实，致使您实交保险费少于应交保险费的，我们有权更正并要求您补交保险费。若已经发生保险事故，我们在给付保险金时按实交保险费与应交保险费的比例给付。(三)您申报的被保险人年龄不真实，致使您实交保险费多于应交保险费的，我们会将多收的保险费退还给您。我们在给付各项保险金、退还现金价值或返还保险费时，若您有欠交的保险费（包含宽限期内欠交的保险费）及其利息、未偿还的保单质押借款及其利息或其他未还款项及其利息，我们将在您偿清上述款项及相关利息后支付保险金、退还现金价值或返还保险费。在本合同履行过程中发生任何争议，当事人应根据本合同约定选择下列两种方式之一予以解决：(一)因履行本合同发生的争议，由当事人协商解决，协商不成的，提交双方共同选定的仲裁委员会，按其当时有效的仲裁规则仲裁解决。(二)因履行本合同发生的争议，由当事人协商解决，协商不成的，依法向有管辖权的人民法院起诉。从本合同生效日或保单周年日零时起至下一年度的保单周年日零时止为一个保单年度。指本合同生效日在合同生效后每年的对应日，不含本合同生效日当日。若当月没有对应的同一日，则以该月最后一日为对应日。若当月无对应的同一日，则以该月最后一日为对应日。指按法定身份证明文件中记载的出生日期计算的年龄，自出生之日起为零周岁，每经过一年增加一岁，不足一年的不计。指由政府主管部门规定的证明其身份的证件，如：居民身份证、按规定可使用的有效护照、军官证、警官证、士兵证、户口簿等证件。指遭受外来的、突发的、非本意的、非疾病的客观事件直接致使身体受到的伤害。指被保险人患同时符合以下条件的疾病：（1）被保险人自出生后首次出现疾病之症状体征；（2）被保险人在本合同有效期间内首次出现疾病之症状体征并被确诊患该疾病；（3）该疾病之症状体征符合本合同的定义；（4）该疾病已在本合同中列明。对于被保险人在本合同生效日前出现的本合同所列的疾病之症状体征或所患的疾病，我们不承担保险责任。指被保险人发生符合以下疾病定义所述条件的疾病（共35种），应当由专科医生明确诊断。指被保险人生前经组织病理学检查被明确诊断为下列恶性病变，并且接受了相应的治疗。（1）原位癌；（2）相当于Binet分期方案A期程度的慢性淋巴细胞白血病；（3）相当于AnnArbor分期方案I期程度的何杰金氏病；（4）皮肤癌（不包括恶性黑色素瘤及已发生转移的皮肤癌）；（5）TNM分期为TNM期或更轻分期的前列腺癌。指被保险人为了治疗明显的冠状动脉狭窄性疾病，首次实际实施了冠状动脉球囊扩张成形术、冠状动脉支架植入术、冠状动脉粥肿斑块切除术或激光冠状动脉成形术。指被保险人因非意外原因实际发生了脑血管的突发病变出现神经系统功能障碍表现，头颅断层扫描（CT）、核磁共振（MRI）等影像学检查证实存在对应病灶，确诊为脑出血、脑栓塞或脑梗塞，在确诊180天后仍然遗留一肢或一肢以上肢体肌力级或级以下的运动功能障碍。为了治疗心脏瓣膜疾病，被保险人实际接受了非开胸的经胸壁打孔内镜手术或经皮经导管介入手术进行的心脏瓣膜置换或修复手术。指被保险人经头颅断层扫描（CT）、核磁共振（MRI）或其他影像学检查被确诊为下列病变，并实际接受了手术或放射治疗。（1）脑垂体瘤；（2）脑囊肿；（3）脑动脉瘤、脑血管瘤。指被保险人为了治疗主动脉疾病实际实施了经皮经导管进行的动脉内手术。主动脉指胸主动脉和腹主动脉，不包括胸主动脉和腹主动脉的分支血管。指因疾病或意外伤害导致一个肢体自腕关节或踝关节近端（靠近躯干端）以上完全性断离。肺脏部分切除手术和肺脏捐献引起的手术不在保障范围内。指因疾病或意外事故实际实施的肝脏部分切除术，手术须有至少一个完整的肝叶切除。因酒精或者滥用药物引致的疾病或者紊乱及/或者因捐赠肝脏而所需的肝脏手术均不在保障范围内。指由于耳蜗的永久损害而实际实施了人工耳蜗植入手术。诊断须经专科医师确认在医学上是必要的，且在植入手术之前已经符合下列全部条件：（1）双耳持续12个月以上重度感音神经性耳聋；（2）使用相应的听力辅助设备效果不佳。指因疾病或胆道创伤导致接受涉及胆总管小肠吻合术的胆道重建手术。手术必须在专科医生认为是医疗所需的情况下进行。胆道闭锁并在保障范围内。指为治疗疾病实际接受了经腹部切开或腹腔镜进行的双侧卵巢或睾丸完全切除手术。部分卵巢或睾丸切除不在保障范围。肾脏部分切除手术和肾脏捐献引起的手术不在保障范围内。指因糖尿病引起的神经及血管病变累及足部，为了维持生命在本公司认可医院内已经进行了至少一个脚趾的截除术。指因疾病或者意外伤害导致单耳听力永久不可逆性丧失，在500赫兹、1000赫兹和2000赫兹语音频率下，平均听阈大于90分贝，且经纯音听力测试、声导抗检测或者听觉诱发电位检测等证实。被保险人在3周岁之前因疾病导致的单耳失聪不在保障范围内。因外伤而实施的脑外科手术不在保障范围内。度房室传导指心房激动在房室交界区、房室束及其分支内发生阻滞，不能正常地传到心室的心脏传导性疾病须满足下列所有条件：（1）心电图显示房室搏动彼此独立，心室率50次/分钟；（2）出现阿斯综合征或心力衰竭的表现；（3）必须持续性依赖心脏起搏器维持心脏正常功能，且已经放置心脏起搏器。指根据颈动脉造影检查结果，确诊一条或以上颈动脉存在严重狭窄性病变（至少一支血管管腔直径减少50以上）。本病须经国家机关认可的有合法资质的专科医生明确诊断，同时必须已经采取以下手术以减轻症状：（1）确实进行动脉内膜切除术；或（2）确实进行血管介入治疗，例如血管成形术及/或进行植入支架或动脉粥样瘤清除手术。手术。手术必须在心脏科医生认为是医学上必需的情况下进行。为清除或引流因意外导致的血肿，需于头部进行开颅或钻孔手术。开颅或钻孔手术必须由专科医生认为是医学上必需的情况下进行。须由相关医学范畴的注册专科医生，经多导睡眠监测仪检查明确诊断为严重阻塞性睡眠呼吸暂停综合征（OSA），并必须符合以下两项条件：（1）被保险人必须现正接受持续气道正压呼吸器（CPAP）之夜间治疗；（2）必须提供睡眠测试的文件证明，显示AHI30及夜间血氧饱和平均值85。指为修复意外伤害或暴力袭击造成的面部毁损，实际接受了在全身麻醉的情r下，由整形外科医生实施的对严重缺陷、缺失、损害或变形的面部形态和结构进行修复或重建的面部整形手术。面部整形手术必须在意外伤害后的180天内实施。因面部外伤后遗留的线条状瘢痕及色素沉着而施行的手术不在保障范围内。意外伤害必须满足下列全部条件：（1）由外在暴力引起并且造成表面可视性伤口和面部骨结构损害的，或面部皮肤度或全层意外烧伤；（2）是造成面部毁损的直接和独立的原因。指为增进视力或治疗某些角膜疾患，已经实施了异体的角膜移植手术。此手术必须由专科医生认为是医学上必需的情况下进行。指因急性可逆性的骨髓造血功能衰竭而导致贫血、中性粒细胞减少和血小板减少，必须由血液科医生的诊断，且病历资料显示接受了下列任一治疗：（1）骨髓刺激疗法至少1个月；（2）免疫抑制剂治疗至少1个月；（3）接受了骨髓移植。指为治疗一条或者一条以上的下列动脉狭窄而实施的血管介入治疗：（1）为下肢或者上肢供血的动脉；（2）肾动脉；（3）肠系膜动脉。须满足下列全部条件：（1）经血管造影术证实一条或者一条以上的上述动脉狭窄达到50或者以上；（2）对一条或者一条以上的上述动脉施行了血管介入治疗，如血管成形术及/或者进行植入支架或者动脉粥样样瘤清除手术。上述动脉疾病的诊断以及相关治疗的必要性必须由血管疾病的专科医生确定。指为治疗脑积水，将一组带单向阀门的分流装置置入体内,将脑脊液从脑室分流到腹腔中吸收，以降低脑脊液的压力。手术必须在神经外科专科医生证实植入分流器为医疗所需的情况下进行。未达到面部表面积的80。对于较小面积度烧伤、轻度面部烧伤、因意外毁容而施行的面部整形手术，若因同一原因导致上述两项或者两项以上情况同时满足，有关的烧伤或者手术在本合同内只能获赔偿一次。受肾上腺切除术。此项手术需由专科医生认定为处理恶性高血压的必要治疗行为。指因丝虫感染导致淋巴管阻塞而造成身体组织出现严重淋巴水肿。此病症须经本公司认可医院的专科医生根据临床表现和微丝蚴的化验结果确诊。急性淋巴管炎或其它原因引起的淋巴水肿并不在保障范围取＝撸ǖ歉锶刃菘俗酆现⒓捶合WHO登革热第级及第级）。出血性登革热的诊断必须由本公司认可医院的专科医生证实。非出血性登革热不在保障范围内。其形态及外观进行修复或者重建），同时必须由专科医生认为该面部毁容是需要接受住院治疗，及其后接受该手术，而对该面部毁容所进行的治疗亦是医疗所需。此手术必须在本公司认可医院内由专科医生认为是医疗上必需的情况下进行，并出具诊断证明。因纯粹整容原因、独立的牙齿修复、独立的鼻骨骨折或者独立的皮肤伤口所进行的手术均不受此保障。指被临床诊断为急性心肌梗塞并接受了急性心肌梗塞治疗，虽然未达到重大疾病急性心肌梗塞的给付标准，但满足下列至少两项条件：（1）典型临床表现，例如急性胸痛等；（2）新近的心电图改变提示急性心肌梗塞；（3）心肌酶或肌钙蛋白有诊断意义的升高，或呈符合急性心肌梗塞的动态性变化；（4）发病90日后，经检查证实左心室功能降低，如左心室射血分数低于50。如被保险人同时或先后达到不典型的急性心肌梗塞、冠状动脉介入手术的赔付标准，我们仅赔付其中一项轻症疾病保险金，赔付后另外一个病种轻症责任终止。严重的骨质疏松，并因此而直接导致脊椎、骨盆、桡骨、尺骨、肱骨、胫骨、股骨骨折。骨质疏松的诊断必须由本公司认可医院合格的专科医生做出，并符合世界卫生组织关于骨质疏松的诊断标准。世界卫生组织关于骨质疏松的定义：骨密度检测，T值小于2.5。指因疾病或意外伤害导致单眼视力永久不可逆性丧失，须满足下列至少一项条件：（1）眼球缺失或摘除；（2）矫正视力低于0.02（采用国际标准视力表，如果使用其它视力表应进行换算）；（3）视野半径小于5度。指被保险人发生符合以下疾病定义所述条件的疾病（共20种），应当由专科医生明确诊断。是一种中枢神经系统的退行性疾病，临床表现为震颤麻痹、共济失调等。必须满足下列全部条件：（1）药物治疗无法控制病情；（2）自主生活能力完全丧失，无法独立完成六项基本日常生活活动中的两项。继发性帕金森综合症不在保障范围内。溃疡性结肠炎是指伴有致命性电解质紊乱及肠道肿胀及有肠破裂的风险的大肠（结肠及直肠）粘膜炎症。须满足下列所有条件：（1）须经由内窥镜检查证实该疾病侵犯全部结肠及直肠，并经病理学组织切片检查证实为溃疡性结肠炎；（2）经专科注册医生以类固醇或免疫抑制剂连续治疗6个月。诊断及治疗均须在本公司认可的医院内由专科医师认为是医疗必须的情况下进行。指因疾病或者意外伤害导致一肢或一肢以上肢体机能永久完全丧失，且未达到重大疾病瘫痪的给付标准。肢体机能永久完全丧失，指疾病确诊180天后或意外伤害发生180天后，每肢三大关节中的两大关节仍然完全僵硬，或不能随意识活动。指一种神经与肌肉接头部位传递障碍的自身免疫性疾病，临床特征是局部或全身肌肉于活动时易于疲劳无力，须经专科医生明确诊断，并满足下列全部条件：（1）经药物治疗或胸腺手术治疗一年以上无法控制病情，症状缓解、复发及恶化交替出现；（2）自主生活能力严重丧失，无法独立完成六项基本日常生活活动中的二项或二项以上。指一种少见的神经系统变性疾病，以假球麻痹、垂直性核上性眼肌麻痹、锥体外系肌僵直、步态共济失调和轻度痴呆为主要临床特征。须满足自主生活能力严重丧失，无法独立完成六项基本日常生活活动中的两项。脊髓灰质炎是由于脊髓灰质炎病毒感染所致的瘫痪性疾病，临床表现为运动功能损害或呼吸无力。脊髓灰质炎必须明确诊断。本合同仅对脊髓灰质炎造成的神经系统功能损害导致被保险人一肢或一肢以上肢体机能永久完全丧失的情况予以理赔。肢体机能永久完全丧失，指疾病确诊180天后，每肢三大关节中的至少一个大关节仍然完全僵硬，或不能随意识活动。指一种罕见的主要发生在老年人之间的可传播的脑病。受感染的人可以有睡眠紊乱，个性改变，共济失调，失语症，视觉丧失，物理，肌肉萎缩，肌阵挛，进行性痴呆等症状。须满足自主生活能力严重丧失，无法独立完成六项基本日常生活活动中的两项。因人类生长激素治疗所致疾病不在保障范围内。指被保险人因疾病或意外伤害导致双目视力永久不可逆性丧失，虽然未达到重大疾病双目失明的给付标准，但满足下列条件之一：（1）双眼中较好眼矫正视力低于0.1（采用国际标准视力表，如果使用其他视力表应进行换算）；（2）双眼中较好眼视野半径小于20度。被保险人申请理赔时年龄必须在3周岁以上，并且提供理赔当时的视力丧失诊断及检查证据。指被保险人因双肾功能慢性不可逆性损害达到肾功能衰竭期，诊断必须满足所有以下标准。
衰竭期	（1）GFR25；（2）Scr5mg/dl或442umol/L；（3）持续180天。
10.重症头部外伤	指因头部遭受机械性外力伤害，引起脑重要部位损伤，并且由头颅断层扫描（CT）、核磁共振检查（MRI）或正电子发射断层扫描（PET）等影像学检查证实。头部外伤导致神经系统功能障碍，虽然未达到重大疾病严重脑损伤的给付标准，但是符合以下条件之一：（1）被保险人接受了全麻下颅骨切开颅内血肿清除术（颅骨钻孔术除外）；（2）在外伤180天后仍然遗留一肢或一肢以上肢体肌力级或级以下的运动功能障碍。
11.较小面积度烧伤（10）	指被保险人的烧伤程度为度，且度烧伤的面积大于全身体表面积的10但小于20。体表面积根据中国新九分法计算。
12.慢性肝功能衰竭	指因慢性肝脏疾病导致肝功能衰竭。须满足下列至少两项条件，但不满足全部条件：（1）持续性黄疸；（2）腹水；（3）肝性脑病；（4）充血性脾肿大伴脾功能亢进或食管胃底静脉曲张。因酗酒或药物滥用导致的肝功能衰竭不在保障范围内。
13.植入腔静脉过滤器	指患者因反复肺栓塞发作，抗凝血疗法无效而接受手术植入腔静脉过滤器。此项手术需由专科医生认定为医学上必需的情况下进行。
14.系统性红斑狼疮	是一种累及多脏器的自身免疫性的炎症性结缔组织病。其诊断须满足下列两个条件：（1）临床表现至少具备如下条件的四个：蝶形红斑或盘形红斑；光敏感；口腔溃疡；非畸形关节炎或多关节痛；浆膜炎、胸膜炎或心包炎；神经系统损伤（癫痫或精神症状）；血象异常（WBC4x109升或血小板100x109升或溶血性贫血）。（2）检测结果至少具备如下条件的两个：狼疮细胞或抗双链DNA抗体阳性；抗Sm抗体阳性；抗核抗体阳性；狼疮带试验阳性；C3补体低于正常。
15.早期运动神经性疾病	是一组中枢神经系统运动神经元的进行性变性疾病，进行性脊肌萎缩症、进行性延髓麻痹症、原发性侧索硬化症、肌萎缩性侧索硬化症。须满足自主生活能力完全丧失，无法独立完成六项基本日常生活活动中的两项。
16.中度类风湿性关节炎	类风湿性关节炎为广泛分布的慢性进行性多关节病变，表现为关节严重变形，侵犯两个主要关节或关节组(如：双手（多手指）关节、双足（多足趾）关节、双腕关节、双膝关节和双髋关节)。且被保险人满足至少180天无法独立完成六项基本日常生活活动中的两项。
17.中度脑中风后遗症	指因脑血管的突发病变引起脑血管出血、栓塞或者梗塞，并导致神经系统出现功能障碍表现，在确诊180天后神经系统功能障碍程度虽未达到重大疾病脑中风后遗症的给付标准，但仍遗留下列一种或者一种以上障碍：（1）一肢或一肢以上肢体肌力III级或III级以下的运动功能障碍；（2）自主生活能力完全丧失，无法独立完成六项基本日常生活活动中的两项或者两项以上。短暂性脑缺血发作(TIA)和腔隙性脑梗塞不在保障范围内。
18.中度强直性脊柱炎	强直性脊柱炎是一种慢性全身性炎性疾病，主要侵犯脊柱导致脊柱畸形。强直性脊柱炎必须明确诊断并且满足下列所有条件：（1）严重脊柱畸形；（2）自主生活能力完全丧失，无法独立完成六项基本日常生活活动中的二项或二项以上。
19.中度脑炎或脑膜炎后遗症	指因患脑炎或者脑膜炎导致的神经系统的功能障碍。疾病确诊180天后，仍存在自主生活能力完全丧失，无法独立完成六项基本日常生活活动中的两项。
20.中度克隆病	是一种慢性肉芽肿性肠炎，具有特征性的克隆病病理组织学变化。诊断必须由专科医生经过病理检查结果证实，被保险人所患的克隆症须经肠胃科专科医生以类固醇或免疫抑制剂连续治疗180天以上，且未达到重大疾病严重克隆病的给付标准。
10.10重大疾病	指被保险人发生符合以下疾病定义所述条件的疾病（共100种），应当由专科医生明确诊断。第1至第25项为中国保险行业协会与中国医师协会共同制定的重大疾病保险的疾病定义，第26至第100项为我们增加的疾病种类并自行制定的疾病定义。
1.恶性肿瘤	指恶性细胞不受控制的进行性增长和扩散，浸润和破坏周围正常组织，可以经血管、淋巴管和体腔扩散转移到身体其它部位的疾病。经病理学检查结果明确诊断，临床诊断属于世界卫生组织疾病和有关健康问题的国际统计分类（ICD10）的恶性肿瘤范畴。下列疾病不在保障范围内：（1）原位癌；（2）相当于Binet分期方案A期程度的慢性淋巴细胞白血病；（3）相当于AnnArbor分期方案I期程度的何杰金氏病；（4）皮肤癌（不包括恶性黑色素瘤及已发生转移的皮肤癌）；（5）TNM分期为T1N0M0期或更轻分期的前列腺癌；（6）感染艾滋病病毒或患艾滋病期间所患恶性肿瘤。少三项条件：（1）典型临床表现，例如急性胸痛等；（2）新近的心电图改变提示急性心肌梗塞；（3）心肌酶或肌钙蛋白有诊断意义的升高，或呈符合急性心肌梗塞的动态性变化；（4）发病90天后，经检查证实左心室功能降低的，如左心室射血分数低于50。功能障碍。神经系统永久性的功能障碍，指疾病确诊180天后，仍遗留下列一种或一种以上障碍：（1）一肢或一肢以上肢体机能完全丧失；（2）语言能力或咀嚼吞咽能力完全丧失；（3）自主生活能力完全丧失，无法独立完成六项基本日常生活活动中的三项或三项以上。
4.重大器官移植术或造血干细胞移植术	重大器官移植术，指因相应器官功能衰竭，已经实施了肾脏、肝脏、心脏或肺脏的异体移植手术。造血干细胞移植术，指因造血功能损害或造血系统恶性肿瘤，已经实施了造血干细胞（包括骨髓造血干细胞、外周血造血干细胞和脐血造血干细胞）的异体移植手术。
5.冠状动脉搭桥术	指为治疗严重的冠心病，实际实施了开胸进行的冠状动脉血管旁路移植的手术。冠状动脉支架植入术、心导管球囊扩张术、激光射频技术及其他非开胸的介入手术、腔镜手术不在保障范围内。
6.终末期肾病	指双肾功能慢性不可逆性衰竭，达到尿毒症期，经诊断后已经进行了至少90天的规律性透析治疗或实施了肾脏移植手术。干端）以上完全性断离。
8.急性或亚急性重症肝炎	指因肝炎病毒感染引起肝脏组织弥漫性坏死，导致急性肝功能衰竭，且经血清学或病毒学检查证实，并须满足下列全部条件：（1）重度黄疸或黄疸迅速加重；（2）肝性脑病；（3）B超或其他影像学检查显示肝脏体积急速萎缩；（4）肝功能指标进行性恶化。
9.良性脑肿瘤	指脑的良性肿瘤，已经引起颅内压增高，临床表现为视神经乳头水肿、精神症状、癫痫及运动感觉障碍等，并危及生命。须由头颅断层扫描（CT）、核磁共振检查（MRI）或正电子发射断层扫描（PET）等影像学检查证实，并须满足下列至少一项条件：（1）实际实施了开颅进行的脑肿瘤完全切除或部分切除的手术；（2）实际实施了对脑肿瘤进行的放射治疗。脑垂体瘤、脑囊肿、脑血管性疾病不在保障范围内。
10.慢性肝功能衰竭失代偿期	指因慢性肝脏疾病导致肝功能衰竭，须满足下列全部条件：（1）持续性黄疸；（2）腹水；（3）肝性脑病；（4）充血性脾肿大伴脾功能亢进或食管胃底静脉曲张。因酗酒或药物滥用导致的肝功能衰竭不在保障范围内。
11.脑炎后遗症或脑膜炎后遗症	指因患脑炎或脑膜炎导致的神经系统永久性的功能障碍。神经系统永久性的功能障碍，指疾病确诊180天后，仍残留下列一种或一种以上障碍：（1）一肢或一肢以上肢体机能完全丧失；（2）语言能力或咀嚼吞咽能力完全丧失；（3）自主生活能力完全丧失，无法独立完成六项基本日常生活活动中的三项或三项以上。
12.深度昏迷	指因疾病或意外伤害导致意识丧失,对外界刺激和体内需求均无反应,昏迷程度按照格拉斯哥昏迷分级（Glasgowcomascale）结果为5分或5分以下，且已经持续使用呼吸机及其它生命维持系统96小时以上。因酗酒或药物滥用导致的深度昏迷不在保障范围内。
13.双耳失聪3周岁始理赔	指因疾病或意外伤害导致双耳听力永久不可逆性丧失，在500赫兹、1000赫兹和2000赫兹语音频率下，平均听阈大于90分贝，且经纯音听力测试、声导抗检测或听觉诱发电位检测等证实。被保险人申请理赔时年龄必须在3周岁以上，并且提供理赔当时的听力丧失诊断及检查证据。
14.双目失明3周岁始理赔	指因疾病或意外伤害导致双眼视力永久不可逆性丧失，双眼中较好眼须满足下列至少一项条件：（1）眼球缺失或摘除；（2）矫正视力低于0.02（采用国际标准视力表，如果使用其他视力表应进行换算）；（3）视野半径小于5度。被保险人申请理赔时年龄必须在3周岁以上，并且提供理赔当时的视力丧失诊断及检查证据。
15.瘫痪	指因疾病或意外伤害导致两肢或两肢以上肢体机能永久完全丧失。肢体机能永久完全丧失，指疾病确诊180天后或意外伤害发生180天后，每肢三大关节中的两大关节仍然完全僵硬，或不能随意识活动。
17.严重阿尔茨海默病	指因大脑进行性、不可逆性改变导致智能严重衰退或丧失，临床表现为明显的认知能力障碍、行为异常和社交能力减退，其日常生活必须持续受到他人监护。须由头颅断层扫描（CT）、核磁共振检查（MRI）或正电子发射断层扫描（PET）等影像学检查证实，且自主生活能力完全丧失，无法独立完成六项基本日常生活活动中的三项或三项以上。神经官能症和精神疾病不在保障范围内。
18.严重脑损伤	指因头部遭受机械性外力，引起脑重要部位损伤，导致神经系统永久性的功能障碍。须由头颅断层扫描（CT）、核磁共振检查（MRI）或正电子发射断层扫描（PET）等影像学检查证实。神经系统永久性的功能障碍，指脑损伤180天后，仍遗留下列一种或一种以上障碍：（1）一肢或一肢以上肢体机能完全丧失；（2）语言能力或咀嚼吞咽能力完全丧失；（3）自主生活能力完全丧失，无法独立完成六项基本日常生活活动中的三项或三项以上。足下列全部条件：（1）药物治疗无法控制病情；（2）自主生活能力完全丧失，无法独立完成六项基本日常生活活动中的三项或三项以上。继发性帕金森综合征不在保障范围内。面积根据中国新九分法计算。
21.严重原发性肺动脉高压	指不明原因的肺动脉压力持续性增高，进行性发展而导致的慢性疾病，已经造成永久不可逆性的体力活动能力受限，达到美国纽约心脏病学会心功能状态分级级，且静息状态下肺动脉平均压超过30mmHg。
22.严重运动神经元病	是一组中枢神经系统运动神经元的进行性变性疾病，包括进行性脊肌萎缩症、进行性延髓麻痹症、原发性侧索硬化症、肌萎缩性侧索硬化症。须满足自主生活能力完全丧失，无法独立完成六项基本日常生活活动中的三项或三项以上的条件。
23.语言能力丧失3岁始理赔	指因疾病或意外伤害导致完全丧失语言能力，经过积极治疗至少12个月（声带3岁始理赔完全切除不受此时间限制），仍无法通过现有医疗手段恢复。精神心理因素所致的语言能力丧失不在保障范围内。被保险人申请理赔时年龄必须在3周岁以上，并且提供理赔当时的语言能力丧失诊断及检查证据。
24.重型再生障碍性贫血	指因骨髓造血功能慢性持续性衰竭导致的贫血、中性粒细胞减少及血小板减少。须满足下列全部条件：（1）骨髓穿刺检查或骨髓活检结果支持诊断；（2）外周血象必须具备以下三项条件：中性粒细胞绝对值0.510/L；网织红细胞1；血小板绝对值2010/L。
25.主动脉手术	指为治疗主动脉疾病，实际实施了开胸或开腹进行的切除、置换、修补病损主动脉血管的手术。主动脉指胸主动脉和腹主动脉，不包括胸主动脉和腹主动脉的分支血管。动脉内血管成形术不在保障范围内。
26.慢性呼吸功能衰竭	慢性肺部疾病导致永久不可逆性的慢性呼吸功能衰竭。慢性呼吸功能衰竭必须明确诊断并满足下列全部条件：（1）休息时出现呼吸困难；（2）动脉血氧分压（PaO2）50mmHg；（3）动脉血氧饱和度（SaO2）80；（4）因缺氧必须接受持续的输氧治疗。
27.严重多发性硬化	多发性硬化为中枢神经系统白质多灶性脱髓鞘病变，病变有时累及灰质。多发性硬化必须明确诊断，并且已经造成永久不可逆的神经系统功能损害。永久不可逆的神经系统损害指被保险人持续180天无法独立完成下列基本日常生活活动：（1）移动：自己从一个房间移动到另一个房间；或（2）进食：自己从已准备好的碗或碟中取食物放入口中。
28.脊髓灰质炎	脊髓灰质炎是由于脊髓灰质炎病毒感染所致的瘫痪性疾病，临床表现为运动功能损害或呼吸无力。脊髓灰质炎必须明确诊断。本合同仅对脊髓灰质炎造成的神经系统功能损害导致被保险人一肢或一肢以上肢体机能永久完全丧失的情况予以理赔。肢体机能永久完全丧失，指疾病确诊180天后，每肢三大关节中的两大关节仍然完全僵硬，或不能随意识活动。
29.全身性重症肌无力	重症肌无力是一种神经肌肉接头传递障碍所致的疾病，表现为局部或全身骨骼肌（特别是眼外肌）极易疲劳。疾病可以累及呼吸肌、上肢或下肢的近端肌群或全身肌肉，必须满足下列全部条件：（1）经药物治疗和胸腺切除治疗一年以上仍无法控制病情；（2）自主生活能力完全丧失，无法独立完成六项基本日常生活活动中的三项或三项以上。
30.严重冠心病	指经根据冠状动脉造影检查结果明确诊断为三支主要血管（左冠状动脉主干和右冠状动脉，或前降支、左旋支和右冠状动脉）严重狭窄性病变（至少一支血管管腔直径减少75以上和其他两支血管管腔直径减少60以上）。前降支、左旋支及右冠状动脉的分支血管的狭窄不作为本保障的衡量指标。
31.严重心肌病	指被保险人因心肌病导致慢性心功能损害造成永久不可逆性的心功能衰竭。心功能衰竭程度达到纽约心脏病学会的心功能分级标准之心功能级。被保险人永久不可逆性的体力活动能力受限，不能从事任何体力活动。
32.系统性红斑狼疮型或以上狼疮性肾炎	系统性红斑狼疮是由多种因素引起，累及多系统的自身免疫性疾病。其特点是生成自身抗体对抗多种自身抗原。多见于育龄妇女。本合同所指的系统性红斑狼疮仅限于累及肾脏（经肾脏活检确认的，符合WHO诊断标准定义型至型狼疮性肾炎）的系统性红斑狼疮。其他类型的红斑性狼疮，如盘状狼疮、仅累及血液及关节的狼疮不在本合同保障范围取Ｊ澜缥郎组织（WHO）狼疮性肾炎分型：型（微小病变型）镜下阴性，尿液正常型（系膜病变型）中度蛋白尿，偶有尿沉渣改变型（局灶及节段增生型）蛋白尿，尿沉渣改变型（弥漫增生型）急性肾炎伴有尿沉渣改变及/或肾病综合征型（膜型）肾病综合征或重度蛋白尿
33.因职业关系导致的人类免疫缺陷病毒（HIV）感染	被保险人在其常规职业工作过程中遭遇外伤，或者职业需要处理血液或者其他体液时感染上人类免疫缺陷病毒（HIV）。必须满足下列全部条件：（1）感染必须是在被保险人正在从事其职业工作中发生，该职业必须属于以下列表内的职业；（2）血清转化必须出现在事故发生后的6个月以内；（3）必须提供被保险人在所报事故发生后的5天以内进行的检查报告，该报告必须显示被保险人血液HIV病毒阴性和/或HIV抗体阴性；（4）必须在事故发生后的12个月内证实被保险人体内存在HIV病毒或者HIV抗体。本公司承担本项疾病责任不受本合同责任免除中被保险人感染艾滋病病毒或患艾滋病的限制。职业限制如下所示:医生和牙科医生护士医院化验室工作人员医院护工医生助理和牙医助理救护车工作人员助产士消防队员警察狱警
34.经输血导致的人类免疫缺陷病毒（HIV）感染	被保险人感染上人类免疫缺陷病毒（HIV）并且满足下列全部条件：（1）在保障起始日或复效日之后，被保险人因输血而感染HIV；（2）提供输血治疗的输血中心或医院出具该项输血感染属医疗责任事故的报告，或者法院终审裁定为医疗责任并且不准上诉；（3）受感染的被保险人不是血友病患者。本公司承担本项疾病责任不受本合同责任免除中被保险人感染艾滋病病毒或患艾滋病的限制。在任何治愈艾滋病（AIDS）或阻止HIV病毒作用的疗法被发现以后，或能防止AIDS发生的医疗方法被研究出来以后，本保障将不再予以赔付。任何因其他传播方式（包括：性传播或静脉注射毒品）导致的HIV感染不在本合同保障范围内。保险公司必须拥有获得使用被保险人的所有血液样本的权利和能够对这些样本进行独立检验的权利。
35.严重克隆病	克隆病是一种慢性肉芽肿性肠炎，具有特征性的克隆病病理组织学变化。诊断必须由病理检查结果证实。被保险人所患的克隆病必须已经造成瘘管形成并伴有肠梗阻或肠穿孔。
36.严重溃疡性结肠炎	本保障所指的严重溃疡性结肠炎是指伴有致命性电解质紊乱的急性暴发性溃疡性结肠炎，病变累及全结肠，表现为严重的血便和系统性症状体征，治疗通常采取全结肠切除和回肠造瘘术。溃疡性结肠炎必须根据组织病理学特点诊断，并且被保险人已经接受了结肠切除和/或回肠造瘘术。
37.严重型糖尿病	型糖尿病的特征为由于胰岛素分泌绝对不足引起严重胰岛素缺乏导致慢性血糖升高，需要依赖外源性胰岛素进行机体的葡萄糖代谢和维持生命。被保险人的型糖尿病必须诊断明确，而且有血胰岛素测定及血C肽或尿C肽测定结果支持诊断，并且已经持续性地接受外源性胰岛素注射治疗连续180天以上。竭。心功能衰竭程度达到纽约心脏病学会的心功能分级标准之心功能级。被保险人永久不可逆性的体力活动能力受限，不能从事任何体力活动。
39.植物人状态	指由于严重颅脑外伤造成大脑和/或脑干严重损害导致完全永久性的对自身和环境的意识丧失和中枢神经系统功能丧失，仅残存植物神经功能的疾病状态。植物人状态必须明确诊断并且具有严重颅脑外伤和脑损害的证据。植物人状态必须持续30天以上方可申请理赔。
关节炎	侵犯至少三个主要关节或关节组如：双手（多手指）关节、双足（多足趾）关节、双腕关节、双膝关节和双髋关节。类风湿性关节炎必须明确诊断并且已经达到类风湿性关节炎功能分级级以上的功能障碍（关节活动严重限制，不能完成大部分的日常工作和活动）并且满足下列全部条件：（1）晨僵；（2）对称性关节炎；（3）类风湿性皮下结节；（4）类风湿因子滴度升高；（5）X线显示严重的关节（软骨和骨）破坏和关节畸形。
41.非阿尔茨海默病所致严重痴呆	指因阿尔茨海默病以外的脑的器质性疾病造成脑功能衰竭导致永久不可逆性的严重痴呆，临床表现为明显的认知能力障碍、行为异常和社交能力减退。被保险人自主生活能力完全丧失，无法独立完成六项基本日常生活活动中的三项或三项以上，日常生活必须持续受到他人监护。导致痴呆的疾病必须明确诊断，并且由完整的临床、实验室和影像学检查结果证实。神经官能症和精神疾病不在保障范围内。
42.多处臂丛神经根性撕脱	由于疾病或意外导致至少两根臂丛神经根性撕脱，所造成的手臂感觉功能与运动功能完全永久性丧失。该病须由医院专科医生明确诊断，并且有电生理检查结果证实。
43.严重哮喘（25周岁前理赔）	指一种反复发作的严重支气管阻塞性疾病，经我们认可的专科医生确诊，且必须同时符合下列标准：（1）过去两年中曾因哮喘持续状态住院治疗，并提供完整住院记录；（2）因慢性过度换气导致胸廓畸形；（3）在家中需要医生处方的氧气治疗法；（4）持续日常服用口服类固醇激素治疗持续至少六个月。被保险人申请理赔时年龄必须在年满25周岁之前。
44.严重川崎病	是指原因不明的系统性血管炎，本病须经专科医师明确诊断，并须满足下列全部条件：（1）超声心动图显示川崎病并发冠状动脉瘤或其他心血管异常；（2）已接受了针对川崎病并发冠状动脉瘤或其他心血管异常所进行的手术治疗。
45.严重的系统性硬皮病	指一种以局限性或弥漫性皮肤增厚和皮肤、血管、内脏器官异常纤维化为特征的结缔组织病。本病须经专科医师明确诊断，并须满足下列至少一项条件：（1）肺脏：肺部病变进而发展为肺间质纤维化和肺动脉高压；（2）心脏：心功能受损达到纽约心脏病学会的心功能分级标准之心功能级；（3）肾脏：肾脏受损导致双肾功能慢性不可逆衰竭，达到尿毒症期。
46.丝虫病所致象皮肿	指因丝虫感染导致淋巴阻塞性出现严重淋巴水肿，达到国际淋巴学会淋巴肿分期第期，临床表现为肢体象皮肿，患肢较键肢增粗30以上，日常生活不能自理。此病症须经专科医生根据临床表现和微丝蚴的化验结果确诊。
47.胰腺移植	指因胰腺功能衰竭，已经实施了在全身麻醉下进行的胰腺的异体器官移植手术。单纯胰岛移植、部分胰腺组织或细胞的移植不在本保障范围之内。
炎开腹手术	除术或胰腺部分切除术。因酒精作用所致的急性胰腺炎不在保障范围内。
49.慢性复发性胰腺炎	指慢性反复发作的胰腺炎症导致胰腺的广泛纤维化、坏死、弥漫性钙化及假性囊肿形成，造成胰腺功能障碍出现严重糖尿病和营养不良。必须满足以下所有条件：（1）CT显示胰腺广泛钙化或逆行胰胆管造影（ERCP）显示胰管扭曲、扩张和狭窄；（2）接受胰岛素替代治疗和酶替代治疗180天以上。酒精导致的慢性复发性胰腺炎不在本保障范围内。
50.疯牛病	是一种传染性海绵状脑病，临床表现为快速进行性痴呆、肌阵挛和特征性脑电图变化。本病须经三级医院的专科医生根据WHO诊断标准明确诊断，并且被保险人自主生活能力完全丧失，无法独立完成六项基本日常生活活动中的三项或三项以上。疑似病例不在本保障范围内。
51.肾髓质囊性病肾髓质囊性病的诊断须同时符合下列要求：	（1）肾髓质有囊肿、肾小管萎缩及间质纤维化等病理改变；（2）肾功能衰竭；（3）诊断须由肾组织活检确定。
52.严重的原发性硬化性胆管炎	原发性硬化性胆管炎指一种胆汁淤积综合征，其特征是肝内、肝外胆道因非细菌性炎症、慢性纤维化逐渐狭窄，并最终导致完全阻塞而发展为胆汁於积性肝硬化。须满足下列全部条件：（1）持续性黄疸病史；（2）总胆红素和直接胆红素同时升高，血清ALP200U/L；（3）经内镜逆行胰胆管造影（ERCP）影像学检查确诊；（4）出现胆汁於积性肝硬化或门脉高压。因肿瘤或胆管损伤等继发性的硬化性胆管炎不在保障范围内。
53.特发性慢性肾上腺皮质功能减退	指自身免疫性肾上腺炎（既往称：特发性肾上腺皮质萎缩）导致肾上腺萎缩和慢性肾上腺皮质功能减退。必须满足所有以下条件：（1）必须由专科医生明确诊断，符合所有以下诊断标准：血浆促肾上腺皮质激素（ACTH）水平测定，100pg/ml；血浆肾素活性、血管紧张素II和醛固酮测定，显示为原发性肾上腺皮质功能减退症；促肾上腺皮质激素（ACTH）刺激试验显示为原发性肾上腺皮质功能减退症。（2）已经采用皮质类固醇替代治疗180天以上。肾上腺结核、HIV感染或艾滋病、感染、肿瘤所致的原发性肾上腺皮质功能减退和继发性肾上腺皮质功能减退不在本保障范围内。
54.溶血性链球菌引起的坏疽	包围肢体或躯干的浅筋膜和/或深筋膜受到溶血性链球菌的感染，病情在短时间内急剧恶化，必须立刻进行手术及清创术。最后的诊断必须由微生物或病理学专家进行相关检查后证实。
55.颅脑手术	被保险人确已实施全麻下的开颅手术（不包括颅骨钻孔手术和经鼻蝶窦入颅手术）。因外伤而实施的脑外科手术不在保障范围之内。理赔时必须提供由神经外科医生出具的诊断书及手术报告。
56.严重肌营养不良症	指一组遗传性肌肉变性病变，临床特征为与神经系统无关的骨骼肌肉对称地进行性无力和萎缩。其诊断需满足下列全部条件：（1）肌电图显示典型肌营养不良症的阳性改变；（2）肌肉活检的病理学诊断符合肌营养不良症的肌肉细胞变性、坏死等阳性改变；（3）已导致被保险人持续超过三个月无法独立完成六项基本日常生活活动中的三项或三项以上。
57.严重心肌炎	指被保险人因严重心肌炎性病变导致心功能损害造成持续的永久不可逆性的心功能衰竭。必须满足所有以下条件：（1）心功能衰竭程度达到纽约心脏病学会的心功能分级标准之心功能级，或左室射血分数低于30；（2）持续不间断180天以上；（3）被保险人永久不可逆性的体力活动能力受限，不能从事任何体力活动。
58.肝豆状核变性(或称Wilson病)	指一种常染色体隐性遗传的铜代谢缺陷病，以不同程度的肝细胞损害、脑退行性病变和角膜边缘有铜盐沉着环为其临床特征，并须满足下列全部条件：（1）典型症状；（2）角膜色素环（KF环）；（3）血清铜和血清铜蓝蛋白降低，尿铜增加；（4）经肝脏活检确诊。
59.侵蚀性葡萄胎(或称恶性葡萄胎)	该类疾病是指异常增生的绒毛组织浸润性生长侵入子宫肌层或转移至其他器官或组织的葡萄胎，并已经进行化疗或手术治疗的。
60.破裂脑动脉瘤夹闭手术	指因脑动脉瘤破裂造成蛛网膜下腔出血，被保险人实际接受了在全麻下进行的开颅动脉瘤夹闭手术。脑动脉瘤（未破裂）预防性手术、颅骨打孔手术、动脉瘤栓塞手术、血管内手术及其他颅脑手术不在本保障范围内。
61.需手术切除的嗜铬细胞瘤	是指肾上腺或嗜铬外组织出现神经内分泌肿瘤，并分泌过多的儿茶酚胺类，需要并实际进行了手术切除肿瘤。嗜铬细胞瘤的诊断必须由内分泌专科医生确定。
62.进行性核上性麻痹(SteeleRchardsonOlszewski综合征)	进行性核上性麻痹（PSP）又称SteeleRchardsonOlszewski综合征，是一种少见的神经系统变性疾病，以假球麻痹、垂直性核上性眼肌麻痹、锥体外系肌僵直、步态共济失调和轻度痴呆为主要临床特征。PSP必须由三级甲等医院的神经内科专科医生确诊，并且被保险人自主生活能力完全丧失，无法独立完成六项基本日常生活活动中的三项或三项以上。
63.严重幼年型类风湿性关节炎	幼年型类风湿关节炎是一种儿童期发病的慢性关节炎，其特点为在高热和系统性病征出现数月后发生关节炎。本合同仅对实际接受了膝关节或髋关节置换手术治疗的严重的幼年型类风湿关节炎予以理赔。
64.严重肠道疾病并发症(本项保险责任仅在被保险人18周岁以前提供保障)	严重肠道疾病或外伤导致小肠损害并发症，必须满足以下所有条件：（1）至少切除了三分之二小肠；（2）完全肠外营养支持3个月以上。本项保险责任仅在被保险人18周岁以前提供保障。
65.严重瑞氏综合症（Reye综合征，也称赖氏综合征、雷氏综合征）	瑞氏综合征是线粒体功能障碍性疾病。导致脂肪代谢障碍，引起短链脂肪酸、血氨升高，造成脑水肿。主要临床表现为急性发热、反复呕吐、惊厥及意识障碍等等。瑞氏综合征需由三级医院的儿科专科医生确诊，并符合下列所有条件：（1）有脑水肿和颅内压升高的脑脊液检查和影像学检查证据；（2）血氨超过正常值的3倍；（3）临床出现昏迷，病程至少达到疾病分期第3期。
66.严重自身免疫性肝炎	自身免疫性肝炎是一种原因不明的慢性肝脏的坏死性炎性疾病，机体免疫机制被破坏，产生针对肝脏自身抗原的抗体导致自身免疫反应，从而破坏肝细胞造成肝脏炎症坏死，进而发展为肝硬化。必须满足所有以下条件：（1）高球蛋白血症；（2）血液中存在高水平的自身免疫抗体，如ANA（抗核抗体）、SMA（抗平滑肌抗体）、抗LKM1抗体或抗SLA/LP抗体；（3）肝脏活检证实免疫性肝炎；（4）临床已经出现腹水、食道静脉曲张和脾肿大等肝硬化表现。
67.严重的度房室传导阻滞	指心房激动在房室交界区、房室束及其分支内发生阻滞，不能正常地传到心室的心脏传导性疾病，须满足下列所有条件：（1）心电图显示房室搏动彼此独立，心室率40次/分钟；（2）动态心电图显示至少3秒的RR间期；（3）出现阿斯综合征或心力衰竭的表现；（4）必须持续性依赖心脏起搏器维持心脏正常功能，且已经放置永久性心脏起搏器。
68.细菌性脑脊髓膜炎	指因脑膜炎双球菌感染引起脑脊髓膜化脓性病变，且导致永久性神经损害，持续90天以上，并且脑脊液检查显示脑膜炎双球菌阳性。永久性神经损害是指由细菌性脑脊髓膜炎引起的耳聋、失明、动眼神经麻痹、瘫痪、脑积水、智力或性情中度以上的损害，且上述症状持续90天以上仍无改善迹象。
69.严重感染性心内膜炎	指因细菌、真菌和其他微生物（如病毒、立克次体、衣原体、螺旋体等）直接感染而产生心瓣膜或心室壁内膜的炎症，须经心脏专科医生确诊，并符合以下所有条件：（1）血液培养测试结果为阳性，并至少符合以下条件之一：微生物：在赘生物、栓塞的赘生物或心脏内脓疡经培养或组织检查证实有微生物；病理性病灶：组织病理学检查证实赘生物或心脏内脓疡有活动性心内膜炎；分别两次血液培养证实有典型的病原体且与心内膜炎吻合；持续血液培养证实有病原体阳性反应，且与心内膜炎吻合。（2）心内膜炎引起中度心瓣膜闭锁不全（指返流分数20或以上）或中度心瓣膜狭窄（指心瓣膜开口范围小于或等于正常的30）；（3）心内膜炎及心瓣膜病损须经心脏专科医生确诊。
70.严重的骨髓增生异常综合征	骨髓增生异常综合征（myelodysplasticsyndromes，MDS）是起源于造血干细胞的一组异质性髓系克隆性疾病，特点是髓系细胞发育异常，表现为无效造血、难治性血细胞减少，本合同所指的严重的骨髓异常增生综合征需满足下列所有条件：（1）由设有专门血液病专科的公立三级甲等医院血液病专科的主治级别以上的医师确诊；（2）骨髓涂片检查同时符合发育异常细胞比例10、原始细胞比例15；（3）已接受至少累计三十日的化疗或已接受骨髓移植治疗。化疗日数的计算以被保险人实际服用、注射化疗药物的天数为准。疑似病例不在保障范围之内。
71.严重癫痫	本病的诊断须由神经科或儿科专科医生根据典型临床症状和脑电图及MRI、PET、CT等影相学检查做出。理赔时必须提供6个月以上的相关病历记录证明被保险人存在经抗癫痫药物治疗无效而反复发作的强直阵挛性发作或癫痫大发作，且已行神经外科手术以治疗反复发作的癫痫。发热性惊厥以及没有全身性发作的失神发作（癫痫小发作）不在本保障范围内。
72.自体造血干细胞移植	指由于患者自身骨髓造血功能异常或为了达到治疗肿瘤的目的，采集患者自己的一部分造血干细胞，分离并深低温保存，再回输给患者使患者的造血功能和免疫功能重新恢复的一种治疗方法。该治疗须由专科医生认为在临床上是必需的。
73.肺淋巴管肌瘤病	肺淋巴管肌瘤病是一种弥漫性肺部疾病，主要病理改变为肺间质、支气管、血管和淋巴管内出现未成熟的平滑肌异常增生，同时需满足下列条件：（1）经组织病理学诊断；（2）CT显示双肺弥漫性囊性改变；（3）血气提示低氧血症。
74.肺泡蛋白质沉积症	指肺泡和细支气管腔内充满不可溶性富磷脂蛋白的疾病，胸部X线呈双肺弥漫性肺部磨玻璃影，病理学检查肺泡内充满有过碘酸雪夫（PAS）染色阳性的蛋白样物质，并且接受了肺灌洗治疗。
75.小肠移植	指因肠道疾病或外伤，已经实施了在全身麻醉下进行的小肠的异体器官移植手术。此手术必须由专科医生认为是医学上必需的情况下进行。
76.疾病或外伤所致智力障碍	因严重头部创伤或疾病造成被保险人智力低常（智力低于常态）。根据智商（IQ），智力低常分为轻度（IQ5070）；中度（IQ3550）；重度（IQ2035）和极重度（IQ20）。智商的检测必须由我们认可的专职心理测验工作者进行，心理测验工作者必须持有由心理测量专业委员会资格认定书。根据被保险人年龄采用对应的智力量表如韦克斯勒智力量表（儿童智力量表或成人智力量表）。理赔时必须满足下列全部条件：（1）造成被保险人智力低常（智力低于常态）的严重头部创伤或疾病（以入院日期为准）发生在被保险人6周岁以后；（2）儿科主任医师确诊被保险人由于严重头部创伤或疾病造成智力低常；（3）专职合格心理检测工作者适时做的心理检测证实被保险人智力低常（轻度、中度、重度或极重度）；（4）被保险人的智力低常自确认日起持续180天以上。型、型、型。只保障型成骨不全的情形。其主要临床特点有：发展迟缓、多发性骨折、进行性脊柱后侧凸及听力损害。型成骨不全的诊断必须根据身体检查，家族史，X线检查和皮肤活检报告资料确诊。上，体表面积根据中国新九分法计算。
79.亚急性硬化性全脑炎	是麻疹或麻疹样病毒所致的一种中枢神经系统慢性感染。中枢神经系统呈现灰质和白质破坏为特征的慢性和急性混合存在的炎症。必须满足以下所有条件：（1）脑电图存在周期性复合波、脑脊液r球蛋白升高、脑脊液和血清中麻疹抗体滴定度升高；（2）被保险人出现运动障碍，自主生活能力完全丧失，无法独立完成六项基本日常生活活动中的三项或三项以上。
80.脊髓小脑变性症	指一组以小脑萎缩和共济失调为主要临床特点的疾病。必须符合所有以下条件：（1）脊髓小脑变性症必须由本公司认可的神经内科专科医生确诊，并有以下全部证据支持：影像学检查证实存在小脑萎缩；临床表现存在共济失调、语言障碍和肌张力异常；（2）被保险人运动功能严重障碍，自主生活能力完全丧失，无法独立完成六项基本日常生活活动中的三项或三项以上。
81.进行性多灶性白质脑病	是一种亚急性脱髓鞘性脑病，常常发生于免疫缺陷的病人。此症必须由本公司认可的神经科专科医生根据脑组织活检确诊。
82.弥漫性血管内凝血	指血液凝固系统和纤溶系统的过度活动导致微血管血栓形成、血小板及凝血因子耗竭和严重出血，此症必须由本公司认可的专科医生确诊，并且已经达到临床分期的中期（消耗性低凝期）或后期（继发性纤溶亢进期），需要输注血浆和浓缩血小板进行治疗。
83.失去一肢及一眼	因疾病或受伤导致不可复原及永久性完全丧失：（1）一眼视力；及（2）任何一肢于腕骨或踝骨部位或以上切断。常生活活动中的三项或三项以上。被保险人的日常生活活动能力丧失必须是永久性的。
85.器官移植导致的HIV感染	指因进行器官移植而感染上人类免疫缺陷病毒（HIV），且须满足下列全部条件：（1）在保障起始日或复效日之后，被保险人因治疗必需而实施器官移植，并且因器官移植而感染人类免疫缺陷病毒；（2）提供器官移植治疗的器官移植中心或医院出具该项器官移植感染，属于医疗责任事故的报告，或者法院终审裁定为医疗责任并且不准上诉；（3）提供器官移植治疗的器官移植中心或医院必须拥有合法经营执照。本公司承担本项疾病责任不受本合同责任免除中被保险人感染艾滋病病毒或患艾滋病的限制。
86.婴儿进行性脊肌萎缩症	该病是累及脊髓前角细胞及延髓运动核的神经元退行性变性病。在出生后两年内出现的脊髓和脑干颅神经前角细胞进行性机能障碍，伴随肌肉无力和延髓机能障碍。本公司承担本项疾病责任不受本合同责任免除中遗传性疾病，先天性畸形、变形或染色体异常的限制。
87.进行性风疹性全脑炎	指由风疹病毒感染引起的儿童和青少年的慢性脑炎。疾病确诊180天后，仍遗留下列一种或一种以上障碍：（1）一肢或一肢以上肢体机能完全丧失；（2）语言能力或咀嚼吞咽能力完全丧失；（3）自主生活能力完全丧失，无法独立完成六项基本日常生活活动中的三项或三项以上。
88.埃博拉病毒感染	指埃博拉病毒感染导致的烈性传染病，并须满足下列全部条件：（1）实验室检查证实埃博拉病毒的存在；（2）从发病开始有超过30天的进行性感染症状。
89.主动脉夹层血肿	指主动脉壁在受到某些病理因素的破坏后，高速、高压的主动脉血流将其内膜撕裂，以致主动脉腔内的血流通过主动脉内膜的破裂口进入主动脉内壁而形成血肿。被保险人需通过X线断层扫描（CT）、磁共振扫描（MRI）、磁共振血管检验法（MRA）或血管扫描等检查，并且实施了胸腹切开的直视主动脉手术。
90.重症急性坏死性筋膜炎	坏死性筋膜炎的诊断须同时符合下列要求：（1）符合坏死性筋膜炎的一般临床表现；（2）细菌培养检出致病菌；（3）出现广泛性肌肉及软组织坏死，并导致身体受影响部位永久完全失去功能。所谓永久完全失去功能是指受影响部位的全部功能完全丧失超过180天者。
91.骨髓纤维化	原发性骨髓纤维化为原因不明的骨髓中成纤维细胞增殖，伴有髓外造血，表现为进行性贫血、脾肿大等症状。本疾病须根据骨髓的活组织检查和周围血象检查由我们认可的医院血液科专科医生明确诊断，并至少符合下列条件中的三项，且符合条件的状态持续180天及以上，并已经实际实施了针对此症的治疗：（1）血红蛋白100g/L；（2）白细胞计数25109/L；（3）外周血原始细胞1；（4）血小板计数100109/L。任何其它病因导致的继发性骨髓纤维化不在保障范围内。
92.严重慢性缩窄性心包炎	由于慢性心包炎症导致心包脏层和壁层广泛瘢痕粘连、增厚和钙化，心包腔闭塞，形成一个纤维瘢痕外壳，使心脏和大血管根部受压，阻碍心脏的舒张。被保险人被明确诊断为慢性缩窄性心包炎且必须满足以下所有条件：（1）心功能衰竭达到美国纽约心脏病学会心功能状态分级级，并持续180天以上；（2）实际接收了以下任何一种手术路径的心包剥脱或心包切除手术；手术路径：胸骨正中切口；双侧前胸切口；左前胸肋间切口。经胸腔镜、胸壁打孔进行的手术、心包粘连松解手术不在保障范围内。主动脉指胸主动脉及腹主动脉而非其旁支。诊断必须由专科医生及检验结果证实，检验包括电脑扫描，磁共振扫描及磁共振血管造影或心导管检查的证明，并有必要进行紧急修补手术。
94.肌萎缩脊髓侧索硬化后遗症	以肌肉无力及萎缩为特征，并有以下情况作为证明：脊髓前角细胞功能失调、可见的肌肉颤动、痉挛、过度活跃之深层肌腱反射和外部足底反射、影响皮质脊髓束、构音障碍及吞咽困难。必须由我们认可的医院专科医生以适当的神经肌肉检查如肌电图（EMG）证实。本疾病必须导致严重的生理功能损坏（由被保险人永久性无法独立完成最少3项基本日常生活活动作为证明）。
95.严重结核性脑膜炎	由结核杆菌引起的脑膜和脊膜的非化脓性炎症性疾病。需满足以下全部条件：（1）出现颅内压明显增高，表现头痛、呕吐和视乳头水肿；（2）出现部分性、全身性癫痫发作或癫痫持续状态；（3）昏睡或意识模糊；（4）视力减退、复视和面神经麻痹。疱疹。经我们认可的医疗机构的专科医生确诊为患有手足口病，并伴有下列三项中的任意一项并发症：（1）有脑膜炎或脑炎并发症，且导致意识障碍或瘫痪的临床表现及实验室检查证据；（2）有肺炎或肺水肿并发症，且导致呼吸衰竭的临床表现及实验室检查证据；（3）有心肌炎并发症，且导致心脏扩大或心力衰竭的临床表现及实验室检查证。
97.严重甲型及乙型血友病	被保人必须是患上严重甲型血友病（缺乏凝血因子）或严重乙型血友病（缺乏凝血因子），而凝血因子或凝血因子的活性水平少于百分之一。诊断必须由本公司认可医院的的血液病专科医生确认。本公司承担本项疾病责任不受本合同责任免除中遗传性疾病，先天性畸形、变形或染色体异常的限制。
98.艾森门格综合征	因心脏病导致的严重肺动脉高压及右向左分流。诊断必须由心脏专科医生经超声心动图和心导管检查证实及需符合以下所有标准：（1）平均肺动脉压高于40mmHg；（2）肺血管阻力高于3mm/L/min（Wood单位）；（3）正常肺微血管楔压低于15mmHg；本公司承担本项疾病责任不受本合同责任免除中遗传性疾病，先天性畸形、变形或染色体异常的限制。
99.湿性年龄相关性黄斑变性	又称为新生血管性年龄相关性黄斑变性或渗出性年龄相关性黄斑变性，发生脉络膜新生血管（CNV）异常生长穿透玻璃膜进入视网膜，新生血管渗漏，渗出及出血。该病必须由荧光素眼底血管造影检查提示黄斑区新生血管形成，并且必须由医院的眼科专科医生确诊为湿性年龄相关性黄斑变性。被保险人申请理赔时须提供近3个月内视力改变显示病情恶化的相关检查报告、诊断证明及病历报告。
100.脊柱裂	指脊椎或颅骨不完全闭合，导致脊髓脊膜突出，脑（脊）膜突出或脑膨出，合并大小便失禁，部分或完全性下肢瘫痪或畸形等神经学上的异常，但不包括由X线摄片发现的没有合并脊椎脊膜突出或脑（脊）膜突出的隐形脊椎裂。本公司承担本项疾病责任不受本合同责任免除中遗传性疾病，先天性畸形、变形或染色体异常的限制。
10.11重大疾病分组	本合同所指的重大疾病分为A、B、C、D、E五组，具体疾病分组情况如下：
10.12全残	指下列情形之一：（1）双目永久完全（注）失明（注）；（2）两上肢腕关节以上或两下肢踝关节以上缺失；（3）一上肢腕关节以上及一下肢踝关节以上缺失；（4）一目永久完全失明及一上肢腕关节以上缺失；（5）一目永久完全失明及一下肢踝关节以上缺失；（6）四肢关节机能永久完全丧失（注）；（7）咀嚼、吞咽机能永久完全丧失（注）；（8）中枢神经系统机能或胸、腹部脏器机能极度障碍，终身不能从事任何工作，为维持生命必要的日常生活活动，全需他人扶助的（注）。全残的鉴定应在治疗结束之后由医疗机构（或鉴定机构）进行。若自被保险人遭受意外伤害之日起180日后治疗仍未结束，按第180日的身体情况进行鉴定。
注：	永久完全系指自上述全残情形发生之日起经过180日的治疗，机能仍完全丧失，但眼球摘除等明显无法复原的情况，不在此限。失明包括眼球缺失或摘除、或不能辨别明暗、或仅能辨别眼前手动者，最佳矫正视力低于国际标准视力表0.02，或视野半径小于5度，并由我们确定的有资格的眼科医师出具医疗诊断证明。关节机能的丧失系指关节永久完全僵硬、或麻痹、或关节不能随意识活动。咀嚼、吞咽机能丧失系指由于牙齿以外的原因引起器质障碍或机能障碍，以至不能作咀嚼、吞咽运动，除流质食物外不能摄取或吞咽的状态。为维持生命必要的日常生活活动，全需他人扶助系指食物摄取、大小便始末、穿脱衣服、起居、步行、入浴等，皆不能自己为之，需要他人帮助。
10.13现金价值	指保险合同所具有的价值，通常体现为解除合同时，根据精算原理计算的，由我们退还的那部分金额。
10.14专科医生	专科医生应当同时满足以下四项资格条件：（1）具有有效的中华人民共和国医师资格证书；（2）具有有效的中华人民共和国医师执业证书，并按期到相关部门登记注册；（3）具有有效的中华人民共和国主治医师或主治医师以上职称的医师职称证书；（4）在二级或二级以上医院的相应科室从事临床工作三年以上。
10.15疾病终末期阶段	疾病终末期阶段需由专科医生出具诊断证明和提交临床检查证据，证明被保险人所患疾病同时满足以下两个条件：（1）依现有医疗技术无法缓解；（2）根据临床医学经验判断被保险人存活期低于六个月。
10.16交费年度数	指本合同自交纳首期保险费后所在的保单年度数与保险单载明的交费期间的较小值。
10.17毒品	指中华人民共和国刑法规定的鸦片、海洛因、甲基苯丙胺（冰毒）、吗啡、大麻、可卡因以及国家规定管制的其他能够使人形成瘾癖的麻醉药品和精神药品，但不包括由医生开具并遵医嘱使用的用于治疗疾病但含有毒品成分的处方药品。
10.18酒后驾驶	指经检测或鉴定，发生事故时车辆驾驶人员每百毫升血液中的酒精含量达到或超过一定的标准，公安机关交通管理部门依据道路交通安全法的规定认定为饮酒后驾驶或醉酒后驾驶。
10.19无合法有效驾驶证驾驶	指下列情形之一：（1）没有驾驶证驾驶；（2）驾驶与驾驶证准驾车型不相符合的车辆；（3）持审验不合格的驾驶证驾驶；（4）持学习驾驶证学习驾车时，无教练员随车指导，或不按指定时间、路线学习驾车。
10.20无有效行驶证	指下列情形之一：（1）机动车被依法注销登记的；（2）未依法按时进行或通过机动车安全技术检验。
10.21机动车	指以动力装置驱动或牵引，上道路行驶的供人员乘用或用于运送物品以及进行工程专项作业的轮式车辆。
10.22感染艾滋病病毒或患艾滋病	艾滋病病毒指人类免疫缺陷病毒，英文缩写为HIV。艾滋病指人类免疫缺陷病毒引起的获得性免疫缺陷综合征，英文缩写为AIDS。在人体血液或其他样本中检测到艾滋病病毒或其抗体呈阳性，没有出现临床症状或体征的，为感染艾滋病病毒；如果同时出现了明显临床症状或体征的，为患艾滋病。
10.23遗传性疾病	指生殖细胞或受精卵的遗传物质（染色体和基因）发生突变或畸变所引起的疾病，通常具有由亲代传至后代的垂直传递的特征。
10.24先天性畸形、变形或染色体异常	指被保险人出生时就具有的畸形、变形或染色体异常。先天性畸形、变形和染色体异常依照世界卫生组织疾病和有关健康问题的国际统计分类（ICD10）确定。
10.25医疗机构	指经中华人民共和国卫生部门正式评定的二级或以上之公立医院，但不包括上述医院的分院、联合病房或联合病床，精神病院，专供康复、休养、戒毒、戒酒、护理、养老等非以直接诊治病人为目的的医疗机构。
10.26利息	本合同保单质押借款的利息按我们收到保单质押借款申请书时已宣布的借款利率计算，我们在每年的1月1日和7月1日根据监管规定和市场情况宣布两次借款利率。借款利率适用于本合同自动垫交的保险费和补交保险费的利息计算。
10.27原位癌	指恶性细胞局限于上皮内尚未穿破基底膜浸润周围正常组织的癌细胞新生物。原位癌必须经对固定活组织的组织病理学检查明确诊断。被保险人必须己经接受了针对原位癌病灶的积极治疗。
10.28永久不可逆	指自疾病确诊或意外发生之日起，经过积极治疗180天后，仍无法通过现有医疗手段恢复。
10.29六项基本日常生活活动	六项基本日常生活活动是指：（1）穿衣：自己能够穿衣及脱衣；（2）移动：自己从一个房间到另一个房间；（3）行动：自己上下床或上下轮椅；（4）如厕：自己控制进行大小便；（5）进食：自己从已准备好的碗或碟中取食物放入口中；（6）洗澡：自己进行淋浴或盆浴。节的整个上肢或包括髋关节的整个下肢。
10.31语言能力或咀嚼吞咽能力完全丧失	语言能力完全丧失，指无法发出四种语音（包括口唇音、齿舌音、口盖音和喉头音）中的任何三种、或声带全部切除，或因大脑语言中枢受伤害而患失语症。咀嚼吞咽能力完全丧失，指因牙齿以外的原因导致器质障碍或机能障碍，以致不能作咀嚼吞咽运动，除流质食物外不能摄取或吞咽的状态。
