question	answer
第一部分	您（投保人）与我们（太平人寿保险有限公司）的合同
第一条保险合同的构成	本合同由以下几个部分构成：保险单及所附条款、投保单（其复印件或电子影像印刷件与正本具有同等效力）、批注，以及经您与我们共同认可的、与本合同有关的其他书面文件。
第二条投保范围	本合同接受的被保险人的投保年龄为出生满28日至65周岁1。
第三条保险合同成立与生效	您提出保险申请、我们同意承保，本合同成立。合同生效日期在保险单上载明。保单年度2、保险费约定支付日3均以该日期计算。
第四条保险期间	本合同的保险期间为终身，自本合同生效日零时起至被保险人身故时止，并在保险单上载明。
第二部分	我们提供哪些保障利益
第五条基本保险金额	本合同的基本保险金额在投保时由您和我们约定，并在保险单或批注上列明。如果该金额发生变更，则以变更后的金额为基本保险金额。
第六条等待期	自本合同生效日零时起90日为等待期。如果本合同曾一次或多次恢复效力，则自每次合同效力恢复之日零时起90日均为等待期。
第七条保险责任	在本合同保险期间内且本合同有效，我们按照下列约定承担给付相应保险金的责任：
一、重大疾病保险金	1.如果被保险人因意外伤害事故4或等待期后因意外伤害事故以外的原因导致被保险人经医院5初次确诊6患上一种或多种本合同第三十三条所定义的重大疾病，我们按本合同的基本保险金额给付重大疾病保险金，同时本合同终止。1周岁：指按照居民身份证、军官证、警官证、士兵证等有效身份证件中记载的出生日期计算的年龄，自出生之日起为零周岁，每经过一年增加一岁，不足一年的不计。2保单年度：从保险合同生效日或年生效对应日零时起至下一年度保险合同生效对应日零时止为一个保单年度。如果当月无对应的同一日，则以该月最后一日为对应日。3保险费约定支付日：指在本合同交费期限内，保险单或批注上列明的合同生效日在每月、每季、每半年或每年（根据交费方式确定）的对应日。如果当月无对应的同一日，则以该月最后一日作为对应日。4意外伤害事故：指外来的、突发的、非本意的、非疾病的使身体受到伤害的客观事件。5医院：国务院卫生行政部门医院等级分类中的二级或二级以上的医院，但不包括主要为门诊、康复、护理、疗养、戒酒、戒毒或相类似的医疗机构。同时该医院必须具有符合有关医院管理规定设置标准的医疗设备，并且提供24小时有合格医师及护士驻院的医疗和护理等服务。6初次确诊：指自被保险人出生之日起第一次经医院确诊患有某种疾病，而不是指自本合同生效、复效之后第一次经医院确诊患有某种疾病。太平福禄康瑞2018终身重大疾病保险，第3页，共31页2.如果被保险人因意外伤害事故以外的原因经医院初次确诊患上一种或多种本合同第三十三条所定义的重大疾病，并且初次确诊时间在等待期内，我们按本合同的已交保险费给付重大疾病保险金，同时本合同终止。
二、特定疾病保险金	1.如果被保险人因意外伤害事故或等待期后因意外伤害事故以外的原因导致被保险人经医院初次确诊患上本合同第三十二条所定义的特定疾病，我们按本合同基本保险金额的20额外给付特定疾病保险金。每种特定疾病限给付一次，给付后该种特定疾病保险金保险责任终止。不同特定疾病可以多次给付，但本合同的特定疾病保险金累计给付以六次为限。当累计给付的特定疾病保险金达到六次时，本项责任终止，但本合同继续有效。如果被保险人因同一原因导致其罹患本合同第三十二条所定义的两种或者两种以上的特定疾病，我们仅按一种特定疾病给付特定疾病保险金。如果被保险人符合特定疾病保险金给付条件，我们在给付第一次特定疾病保险金的同时，将豁免本合同在第一次特定疾病确诊日后的首个保险费约定支付日至交费期满之间本合同剩余的各期保险费，但不包括第一次特定疾病确诊日之前所欠交的保险费及利息。2.如果被保险人因意外伤害事故以外的原因经医院初次确诊患上本合同第三十二条所定义的特定疾病，并且初次确诊时间在等待期内，我们不承担本项责任，同时本项责任终止。
三、身故保险金	1.如果被保险人因意外伤害事故或等待期后因意外伤害事故以外的原因导致身故，我们按以下方式给付身故保险金，同时本合同终止。（1）如果被保险人在18周岁的保险单周年日7零时之前身故，身故保险金本合同的年交保险费被保险人身故时本合同的保单年度数8或交费年期数9（以较小者为准）。（2）如果被保险人在18周岁的保险单周年日零时之后身故，或被保险人投保时年龄已满18周岁且在本合同保险期间内身故，我们按被保险人身故时本合同的基本保险金额给付身故保险金。上述年交保险费以被保险人身故时的交费方式为基础计算，如果为趸交10则对应趸交保险费率，如果为分期支付则对应年交保险费率，以被保险人身故时的基本保险金额对应的年交保险费率为基础，按投保时被保险人的年龄计算。2.如果被保险人在等待期内因意外伤害事故以外的原因导致身故，我们按本合同已交保险费给付身故保险金，同时本合同终止。我们只给付本合同保险责任中约定的重大疾病保险金及身故保险金的其中一项保险金。
第八条责任免除	一、因下列情形之一导致被保险人患上本合同所定义的重大疾病或特定疾病的，我们不承担给付相应保险金的责任：1.投保人对被保险人的故意杀害、故意伤害；2.被保险人故意自伤、故意犯罪或者抗拒依法采取的刑事强制措施；7保险单周年日：指在本合同有效期内，每一个保单年度内本合同生效日期的对应日。如果当月无对应的同一日，则以该月最后一日为对应日。8保单年度数：指保险单自承保后所处的年度数。承保后首年的保单年度数为1，此后每到达一个保险单周年日，保单年度数增加1。例如，如果本合同生效日为2003年7月1日，自2003年7月1日至2004年6月30日保单年度数为1，自2004年7月1日至2005年6月30日保单年度数为2，后续年度以此类推。（以上示例仅供您辅助理解之用，实际合同生效日在保险单或批注上列明）9交费年期数：指保险单中约定的交费年期的数值。如果交费方式为趸交，则交费年期数为1。10趸交：指一次性支付保险费。太平福禄康瑞2018终身重大疾病保险，第4页，共31页3.被保险人主动吸食或注射毒品11；4.被保险人酒后驾驶12，无合法有效驾驶证驾驶13，或驾驶无有效行驶证14的机动车15；5.被保险人感染艾滋病病毒或患艾滋病16；6.战争、军事冲突、暴乱或武装叛乱；7.核爆炸、核辐射或核污染；8.遗传性疾病17，先天性畸形、变形或染色体异常18。发生上述第1项情形导致被保险人患上本合同所定义的重大疾病的，本合同终止，您已交足2年以上保险费的，我们向其他权利人退还保险单的现金价值19。发生上述其他情形导致被保险人患上本合同所定义的重大疾病的，本合同终止，我们向您退还保险单的现金价值。
二、因下列情形之一导致被保险人身故的，我们不承担给付身故保险金的责任：	1.投保人对被保险人的故意杀害、故意伤害；2.被保险人故意犯罪或者抗拒依法采取的刑事强制措施；3.被保险人自本合同成立或者合同效力恢复之日起2年内自杀，但被保险人自杀时为无民事行为能力人的除外；4.被保险人主动吸食或注射毒品；5.被保险人酒后驾驶，无合法有效驾驶证驾驶，或驾驶无有效行驶证的机动车；6.战争、军事冲突、暴乱或武装叛乱；7.核爆炸、核辐射或核污染。发生上述第1项情形导致被保险人身故的，本合同终止，您已交足2年以上保险费的，我们向其他权利人退还保险单的现金价值。发生上述其他情形导致被保险人身故的，本合同终止，我们向您退还保险单的现金价值。11毒品：指中华人民共和国刑法规定的鸦片、海洛因、甲基苯丙胺（冰毒）、吗啡、大麻、可卡因以及国家规定管制的其他能够使人形成瘾癖的麻醉药品和精神药品，但不包括由医生开具并遵医嘱使用的用于治疗疾病但含有毒品成分的处方药品。12酒后驾驶：指经检测或鉴定，发生事故时车辆驾驶人员每百毫升血液中的酒精含量达到或超过一定的标准，公安机关交通管理部门依据道路交通安全法的规定认定为饮酒后驾驶或醉酒驾驶。13无合法有效驾驶证驾驶：指下列情形之一：（1）没有取得驾驶资格；（2）驾驶与驾驶证准驾车型不相符合的车辆；（3）持审验不合格的驾驶证驾驶；（4）持学习驾驶证学习驾车时，无教练员随车指导，或不按指定时间、路线学习驾车。14无有效行驶证：指发生保险事故时没有按照公安机关交通管理部门机动车登记制度的规定进行登记并领取机动车行驶证或者临时通行牌证等法定证件。包括下列情形之一：（1）未办理行驶证或者行驶证在申办过程中的；（2）机动车行驶证被依法注销登记的；（3）未在行驶证检验有效期内依法按时进行或者未通过机动车安全技术检验的。15机动车：指以动力装置驱动或者牵引，上道路行驶的供人员乘用或者用于运送物品以及进行工程专项作业的轮式车辆。16感染艾滋病病毒或患艾滋病：艾滋病病毒指人类免疫缺陷病毒，英文缩写为HIV。艾滋病指人类免疫缺陷病毒引起的获得性免疫缺陷综合征，英文缩写为AIDS。在人体血液或其他样本中检测到艾滋病病毒或其抗体呈阳性，没有出现临床症状或体征的，为感染艾滋病病毒；如果同时出现了明显临床症状或体征的，为患艾滋病。17遗传性疾病：指生殖细胞或受精卵的遗传物质（染色体和基因）发生突变或畸变所引起的疾病，通常具有由亲代传至后代的垂直传递的特征。18先天性畸形、变形或染色体异常：指被保险人出生时就具有的畸形、变形或染色体异常。先天性畸形、变形和染色体异常依照世界卫生组织疾病和有关健康问题的国际统计分类（ICD10）确定。19现金价值：指保险单所具有的价值，通常体现为解除合同时，根据精算原理计算的，由我们退还的那部分金额。保单年度末本合同所具有的现金价值在保险单或批注上列明。每个保单年度中，本合同所具有的现金价值根据本合同实际经过的日数计算。太平福禄康瑞2018终身重大疾病保险，第5页，共31页
第三部分	如何支付保险费
第九条保险费的支付	本合同保险费的交费方式和交费期限由您和我们约定，并在保险单或批注上列明。您可以选择趸交或分期支付保险费。选择分期支付保险费的，您在支付了首期保险费后，应按本合同的约定在每个保险费约定支付日支付当期应支付的保险费。
第十条宽限期	分期支付保险费的，您支付首期保险费后，除本合同另有约定外，如果您到期未支付保险费，自保险费约定支付日的次日零时起60日为宽限期。宽限期内发生的保险事故20，我们仍会承担保险责任，但在给付保险金时会扣减您欠交的保险费。如果您宽限期结束之后仍未支付保险费，则本合同自宽限期满的次日零时起效力中止。
第四部分	如何申请保险金
第十一条受益人	除另有约定外，重大疾病保险金、特定疾病保险金的受益人为被保险人本人。您或者被保险人可以指定一人或多人为身故保险金受益人。身故保险金受益人为多人时，可以确定受益顺序和受益份额；如果没有确定份额，各受益人按照相等份额享有受益权。被保险人为无民事行为能力人或限制民事行为能力人的，可以由其监护人指定受益人。您或者被保险人可以变更身故保险金受益人并书面通知我们。我们收到变更受益人的书面通知后，在保险单或其他保险凭证上批注或附贴批单。您在指定和变更身故保险金受益人时，必须经过被保险人同意。被保险人身故后，有下列情形之一的，保险金作为被保险人的遗产，由我们依照中华人民共和国继承法的规定履行给付保险金的义务：一、没有指定受益人，或者受益人指定不明无法确定的；二、受益人先于被保险人身故，没有其他受益人的；三、受益人依法丧失受益权或者放弃受益权，没有其他受益人的。受益人与被保险人在同一事件中身故，且不能确定身故先后顺序的，推定受益人身故在先。受益人故意造成被保险人身故、伤残、疾病的，或者故意杀害被保险人未遂的，该受益人丧失受益权。
第十二条保险事故通知	您或受益人知道保险事故后应当在10日内通知我们。如果您或受益人故意或者因重大过失未及时通知，致使保险事故的性质、原因、损失程度等难以确定的，我们对无法确定的部分，不承担给付保险金的责任，但我们通过其他途径已经及时知道或者应当及时知道保险事故发生或者虽未及时通知但不影响我们确定保险事故的性质、原因、损失程度的除外。
第十三条诉讼时效	人寿保险以外的其他保险的被保险人或者受益人，向我们请求赔偿或者给付保险金的诉讼时效期间为2年，自其知道或者应当知道保险事故发生之日起计算。人寿保险的被保险人或者受益人向我们请求给付保险金的诉讼时效期间为5年，自其知道或者应当知道20保险事故：指本合同约定的保险责任范围内的事故。太平福禄康瑞2018终身重大疾病保险，第6页，共31页保险事故发生之日起计算。
第十四条保险金申请	
一、重大疾病保险金、特定疾病保险金的申请	在申请重大疾病保险金、特定疾病保险金时，由相应保险金的受益人作为申请人填写保险金给付申请书，并提供下列证明和资料：1.保险合同；2.受益人的有效身份证件21；3.医院出具的附有被保险人病理、血液及其他科学方法检验报告等诊断证明文件；4.所能提供的与确认保险事故的性质、原因等有关的其他证明和资料。
二、身故保险金的申请	在申请身故保险金时，由身故保险金的受益人作为申请人填写保险金给付申请书，并提供下列证明和资料：1.保险合同；2.受益人的有效身份证件；3.国务院卫生行政部门规定的医疗机构、公安机关或其他相关机构出具的被保险人的死亡证明；4.所能提供的与确认保险事故的性质、原因等有关的其他证明和资料。如果委托他人代为申请，除上述证明和资料外，还须提供相关保险金受益人的授权委托书、受托人有效身份证件等相关证明文件。保险金作为被保险人遗产时，还须提供可证明合法继承权的相关权利文件。受益人或继承人为未成年人或无民事行为能力人时，由其合法监护人代其申请领取保险金，其合法监护人还必须提供受益人或继承人为未成年人或无民事行为能力人的证明和监护人具有合法监护权的证明。以上证明和资料不完整的，我们将及时一次性通知申请人补充提供有关证明和资料。
第十五条保险金给付	我们在收到保险金给付申请书及合同约定的证明和资料后，将在5个工作日内作出核定；情形复杂的，在30日内作出核定。对属于保险责任的，我们在与受益人达成给付保险金的协议后10日内，履行给付保险金义务。我们未及时履行前款规定义务的，除支付保险金外，应当赔偿受益人因此受到的损失。对不属于保险责任的，我们自作出核定之日起3日内向受益人发出拒绝给付保险金通知书并说明理由。我们在收到保险金给付申请书及有关证明和资料之日起60日内，对给付保险金的数额不能确定的，根据已有证明和资料可以确定的数额先予支付；我们最终确定给付保险金的数额后，将支付相应的差额。
第十六条司法鉴定	如果被保险人身故，我们有权要求司法鉴定机构对保险事故进行鉴定。
第十七条失踪处理	在本合同保险期间内且本合同有效，如果被保险人失踪，且经法院宣告死亡，申请人可以向我们申请身故保险金，我们以法院判决宣告之被保险人死亡日为被保险人死亡的日期，并且按本合同中与身故有关的约定处理。如果被保险人被宣告死亡之日在保险期间之外，但有证据证明下落不明之日在本合同有效期内，我们仍承担与身故有关的保险责任，并按合同终止日计算保险金的金额。21有效身份证件：指由政府主管部门规定的证明其身份的证件，如居民身份证、军官证、警官证、士兵证等证件。太平福禄康瑞2018终身重大疾病保险，第7页，共31页如果被保险人在宣告死亡后重新出现或确知其下落，身故保险金受益人应在知道被保险人生还之日起30日内，向我们退还已领取的身故保险金。退还保险金后，本合同的效力由您和我们协商处理。
第五部分	您还享有哪些权益
第十八条保单贷款	在本合同犹豫期之后，如果本合同具有现金价值，经被保险人书面同意，您可以向我们申请保单贷款。保单贷款的最高金额不超过本合同当时所具有的现金价值净额22的80（最低金额不得少于人民币1000元，我们将不定期调整最低贷款金额），具体额度需经我们审批。每一期贷款的最长期限为6个月。保单贷款利率按您与我们签订的贷款协议中约定的利率执行。如果您没有未偿还的保单贷款，您申请的保单贷款按我们最近一次确定的保单贷款利率每日计息，每一期贷款适用的保单贷款利率在贷款期限内固定不变。如果您有未偿还的保单贷款，您可以申请增加贷款，但具体额度需经我们审批，增加的保单贷款的期限为当期未偿还的保单贷款的剩余期限。增加的保单贷款按当期未偿还的保单贷款适用的贷款利率每日计息。保单贷款期满时，如果您未能全部偿还保单贷款及累积利息23，且本合同的现金价值净额大于零，未偿还的保单贷款及累积利息将构成新一期的保单贷款，贷款期限为6个月，并按我们届时执行的最新保单贷款利率计息。您可以在保单贷款期满时，或保单贷款期满前偿还全部或部分的贷款及累积利息，还款将首先用于偿还累积利息，然后用于偿还贷款本金。当本合同的现金价值净额小于或等于零时，本合同的效力中止。
第十九条年金转换权	您或者受益人与我们协商同意后，有权按以下方式申请订立我们当时提供的保险金转换年金保险合同：方式一：受益人在申请本合同的保险金时，可将保险金全部或部分转换成年金。方式二：本合同生效第20个保险单周年日之后，如果您申请解除本合同，或依据我们届时的相关政策进行减保24，您可将我们所退还的现金价值全部或部分转换成年金。申请转换的保险金、现金价值总额不得低于转换当时我们规定的最低限额。
第二十条合同内容的变更权	您和我们协商同意后，有权变更本合同的有关内容，并由我们在保险单或保险凭证上批注，或签订合同变更的书面协议。
第二十一条合同效力的中止与恢复	在本合同效力中止期间，我们不承担保险责任。本合同效力中止后2年内，您可以申请恢复合同效力。申请恢复合同效力时，您应履行如实告知义务（有关如实告知义务的具体内容及相应责任，参见本合同第二十四条）。因欠交保险费导致合同效力中止的，经我们与您协商并达成协议，在您补交保险费及累积利息之日起，合同效力恢复。22现金价值净额：指现金价值在扣除尚未偿还的保单贷款、欠交的保险费、累积利息和其他未还款项后的余额。23累积利息：指根据我们确定的保单贷款利率计算的金额。如果本合同有欠交的保险费或保单贷款，我们将每半年复利计息一次。24减保：是指将本合同的基本保险金额减少，我们将退还减少部分对应的现金价值。太平福禄康瑞2018终身重大疾病保险，第8页，共31页因保单贷款导致合同效力中止的，经我们与您协商并达成协议，在您偿还保单贷款、累积利息及其他未还款项之日起，合同效力恢复。自本合同效力中止之日起满2年您和我们未达成协议的，我们有权解除合同。我们解除合同的，向您退还合同效力中止时保险单的现金价值。
第二十二条犹豫期	您在收到本合同并签收之日起可享有10日的犹豫期，在犹豫期内要求解除本合同的，在我们收齐相关文件和资料的次日零时，本合同即被解除，我们自始不承担保险责任。我们在扣除10元工本费后，无息退还已交保险费。
第二十三条您解除合同的手续及风险	如您在犹豫期后申请解除本合同，请填写解除合同申请书并向我们提供下列资料：一、保险合同；二、您的有效身份证件。自我们收到解除合同申请书时起，本合同终止。我们自收到解除合同申请书之日起30日内向您退还保险单的现金价值。您犹豫期后解除合同会遭受一定损失。
第六部分	您必须了解的其他事项
第二十四条明确说明与如实告知	订立本合同时，我们应向您说明本合同的内容。对保险条款中免除我们责任的条款，我们在订立合同时应当在投保单、保险单或者其他保险凭证上作出足以引起您注意的提示，并对该条款的内容以书面或者口头形式向您作出明确说明，未作提示或者明确说明的，该条款不产生效力。我们就您和被保险人的有关情况提出询问，您应当如实告知。如果您故意或者因重大过失未履行前款规定的如实告知义务，足以影响我们决定是否同意承保或者提高保险费率的，我们有权解除本合同。如果您故意不履行如实告知义务，对于本合同解除前发生的保险事故，我们不承担给付保险金的责任，并不退还保险费。如果您因重大过失未履行如实告知义务，对保险事故的发生有严重影响的，对于本合同解除前发生的保险事故，我们不承担给付保险金的责任，但应当退还保险费。我们在合同订立时已经知道您未如实告知的情况的，我们不得解除合同；发生保险事故的，我们承担给付保险金的责任。
第二十五条我们合同解除权的限制	前条规定的合同解除权，自我们知道有解除事由之日起，超过30日不行使而消灭。自本合同成立之日起超过2年的，我们不得解除合同；发生保险事故的，我们承担给付保险金的责任。
第二十六条年龄错误	您在申请投保时，应将与有效身份证件相符的被保险人的出生日期在投保单上填明，如果发生错误按照下列方式办理：一、您申报的被保险人年龄不真实，并且其真实年龄不符合本合同约定投保年龄限制的，在保险事故发生之前我们有权解除合同，并向您退还保险单的现金价值。我们行使合同解除权适用我们合同解除权的限太平福禄康瑞2018终身重大疾病保险，第9页，共31页制的规定。二、您申报的被保险人年龄不真实，致使您实付保险费少于应付保险费的，我们有权更正并要求您补交保险费。若已经发生保险事故，在给付保险金时按实付保险费和应付保险费的比例给付。三、您申报的被保险人年龄不真实，致使您实付保险费多于应付保险费的，我们会将多收的保险费退还给您。
第二十七条性别错误	您在申请投保时，应将与有效身份证件相符的被保险人的性别在投保单上填明，如果发生错误按照下列方式办理：一、您申报的被保险人性别不真实，致使您实付保险费少于应付保险费的，我们有权更正并要求您补交保险费。若已经发生保险事故，在给付保险金时按实付保险费和应付保险费的比例给付。二、您申报的被保险人性别不真实，致使您实付保险费多于应付保险费的，我们会将多收的保险费退还给您。
第二十八条未还款项	我们在给付各项保险金、退还现金价值或返还保险费时，如果您有欠交的保险费或其他未还款项，我们会在扣除上述款项及累积利息后给付。您欠交的保险费或其他未还款项将以保单贷款的方式计算累积利息。关于保单贷款请参见第十八条。
第二十九条保险合同的终止	除本合同另有约定外，本合同在发生下列情况之一时自动终止：一、我们已按本合同的约定给付重大疾病保险金；二、我们已按本合同的约定给付身故保险金；三、本合同内约定的其他终止情况。
第三十条联系方式的变更	为了保障您的权益，如果您的联系方式（如联系地址、联系电话、电子邮箱等）发生变化，请及时通知我们。否则，我们将按已知的最后联系方式与您联系。
第三十一条争议处理	在合同履行过程中，双方发生争议时，可以从下列两种方式中选择一种争议处理方式：一、因履行本合同发生的争议，由双方协商解决，协商不成的，由双方达成仲裁协议通过仲裁解决；二、因履行本合同发生的争议，由双方协商解决，协商不成的，依法向人民法院起诉。如果双方选择仲裁方式，应当达成仲裁协议并明确约定仲裁事项、仲裁机构。
第三十二条特定疾病的种类及定义	本合同所保障的特定疾病，是指被保险人经专科医生25明确诊断初次发生下列疾病或初次达到下列疾病状态或在医院初次接受下列手术。本合同所保障的特定疾病共50种。
1.极早期恶性肿瘤或者	极早期恶性肿瘤或者指经组织病理学检查被明确诊断为下列恶性病变，并且接受了相应的治25专科医生：专科医生应当同时满足以下四项资格条件：（1）具有有效的中华人民共和国医师资格证书；（2）具有有效的中华人民共和国医师执业证书，并按期到相关部门登记注册；（3）具有有效的中华人民共和国主治医师或主治医师以上职称的医师职称证书；（4）在二级或二级以上医院的相应科室从事临床工作三年以上。太平福禄康瑞2018终身重大疾病保险，第10页，共31页恶性病变疗。（1）原位癌；（2）相当于Binet分期方案A期程度的慢性淋巴细胞白血病；（3）相当于AnnArbor分期方案I期程度的何杰金氏病；（4）皮肤癌（不包括恶性黑色素瘤及已发生转移的皮肤癌）；（5）TNM分期为T1N0M0期或者更轻分期的前列腺癌。
2.轻微脑中风	轻微脑中风指被保险人实际发生了脑血管的突发病变出现神经系统功能障碍表现，头颅X线断层扫描（CT）、核磁共振检查（MRI）等影像学检查证实存在对应病灶，确诊为脑出血、脑栓塞或脑梗塞，在确诊180天后遗留神经系统功能障碍。后遗的神经系统功能障碍程度未达到本合同所指重大疾病脑中风后遗症的给付标准，但仍遗留下列一种或一种以上障碍：（1）一侧肢体（上肢和下肢）肌力II级或II级以下；（2）自主生活能力部分丧失，无法独立完成六项基本日常生活活动26中的两项或两项以上。
3.心脏瓣膜介入手术（非	心脏瓣膜介入手术（非为了治疗心脏瓣膜疾病，实际实施了非开胸的经胸壁打孔内镜手术或者开胸手术）经皮经导管介入手术进行的心脏瓣膜置换或者修复手术。
4.主动脉内手术（非开胸	主动脉内手术（非开胸为了治疗主动脉疾病实际实施了经皮经导管进行的动脉内手术。主动脉手术）指胸主动脉和腹主动脉，不包括胸主动脉和腹主动脉的分支血管。
5.心包膜切除术	心包膜切除术指为治疗心包膜疾病，已经实施了心包膜切除术，但未达到本合同所指重大疾病严重慢性缩窄型心包炎的标准。手术必须在心脏科医生认为是医学上必需的情况下进行。
6.于颈动脉进行血管成	于颈动脉进行血管成指根据颈动脉造影检查结果，确诊一条或以上颈动脉存在严重狭窄性病形术或内膜切除术变（至少一支血管管腔直径减少50以上）。本病须经国家机关认可的有合法资质的专科医生明确诊断，同时必须已经采取以下手术以减轻症状：（1）确实进行动脉内膜切除术；（2）确实进行血管介入治疗，例如血管成形术及/或进行植入支架或动脉粥样瘤清除手术。
7.不典型的急性心肌梗	不典型的急性心肌梗指被临床诊断为急性心肌梗塞并接受了急性心肌梗塞治疗，须满足下列塞至少两项条件，但未达到本合同所指重大疾病急性心肌梗塞的标准：（1）典型临床表现，例如急性胸痛等；（2）新近的心电图改变提示急性心肌梗塞；（3）心肌酶或肌钙蛋白有诊断意义的升高，或呈符合急性心肌梗塞的动态性变化；（4）发病90天后，经检查证实左心室功能降低，如左心室射血分数低于50。我们仅对不典型的急性心肌梗塞、冠状动脉介入手术（非开胸手术）和激光心肌血运重建术三项中的其中一项承担保险责任，给付其中一项保险金后，对其他两项特定疾病保险责任同时终止。
8.冠状动脉介入手术（非	冠状动脉介入手术（非为了治疗明显的冠状动脉狭窄性疾病，首次实际实施了冠状动脉球囊扩开胸手术）张成形术、冠状动脉支架植入术、冠状动脉粥肿斑块切除术或者激光冠状动脉成形术。被保险人已达到本合同所指重大疾病急性心肌梗塞或严重冠状动26六项基本日常生活活动：指食物摄取、大小便始末、穿脱衣服、起居、步行、入浴。太平福禄康瑞2018终身重大疾病保险，第11页，共31页脉粥样硬化性心脏病标准的，我们不承担本项手术保险责任。我们仅对不典型的急性心肌梗塞、冠状动脉介入手术（非开胸手术）、和激光心肌血运重建术三项中的其中一项承担保险责任，给付其中一项保险金后，对其他两项特定疾病保险责任同时终止。
9.激光心肌血运重建术	激光心肌血运重建术指患有顽固性心绞痛，经持续药物治疗后无改善，冠状动脉搭桥手术及经皮血管成形手术已失败或者被认为不适合。在我们认可医院内实际进行了开胸手术下或者胸腔镜下的激光心肌血运重建术。被保险人已达到本合同所指重大疾病急性心肌梗塞或严重冠状动脉粥样硬化性心脏病标准的，我们不承担本项手术保险责任。我们仅对不典型的急性心肌梗塞、冠状动脉介入手术（非开胸手术）、和激光心肌血运重建术三项中的其中一项承担保险责任，给付其中一项保险金后，对其他两项特定疾病保险责任同时终止。
10.起搏器或除颤器植入	因严重心律失常而确实已经实施植入永久性心脏除纤颤器或心脏起搏器的手术。理赔时须提供完整病历资料及手术记录，诊断及治疗均须专科医生认为是医疗必须的情况下进行。
11.原发性肺动脉高压	指由于原发性肺动脉高压进行性发展而导致右心室肥厚，已经造成永久不可逆27性的体力活动能力受限，达到美国纽约心脏病学会心功能状态分级级及以上，但尚未达到IV级，且静息状态下肺动脉平均压超过25mmHg，但尚未超过30mmHg。
12.特定周围动脉疾病的	指为治疗一条或者一条以上的下动脉狭窄而实施的血管介入治疗：血管介入治疗（1）为下肢或者上肢供血的动脉；（2）肾动脉；（3）肠系膜动脉。须满足下列全部条件：（1）经血管造影术证实一条或者一条以上的上述动脉狭窄达到50或者以上；（2）对一条或者一条以上的上述动脉施行了血管介入治疗，如血管成形术及/或者进行植入支架或者动脉瘤清除手术。上述动脉疾病的诊断以及相关治疗的必要性必须由血管疾病的专科医生确定。
13.脑动脉瘤夹闭手术或	被保险人实际接受了对未破裂脑动脉瘤的动脉瘤夹闭手术或动脉瘤栓塞栓塞手术手术。我们对脑动脉瘤夹闭手术或栓塞手术和微创颅脑手术、脑垂体瘤、脑囊肿、脑动脉瘤及脑血管瘤、植入大脑内分流器四项中的其中一项承担保险责任，给付其中一项保险金后，对其他三项特定疾病保险责任同时终止。
14.微创颅脑手术	因疾病被保险人确已实施全麻下的颅骨钻孔手术或者经鼻蝶窦入颅手术。因外伤而实施的脑外科手术不在保障范围内。我们对脑动脉瘤夹闭手术或栓塞手术和微创颅脑手术、脑垂体瘤、脑囊肿、脑动脉瘤及脑血管瘤、植入大脑内分流器四项中的其中一项承担保险责任，给付其中一项保险金后，对其他三项特定疾病保27永久不可逆：指自疾病确诊或意外伤害发生之日起，经过积极治疗180天后，仍无法通过现有医疗手段恢复。太平福禄康瑞2018终身重大疾病保险，第12页，共31页险责任同时终止。我们对微创颅脑手术和重症头部外伤、硬脑膜下血肿手术三项中的其中一项承担保险责任，给付其中一项保险金后，对其他两项特定疾病保险责任同时终止。
15.脑垂体瘤、脑囊肿、脑	指经头颅断层扫描（CT）、核磁共振检查（MRI）或者其他影像学检查被动脉瘤及脑血管瘤确诊为下列病变，并实际接受了手术或者放射治疗。（1）脑垂体瘤；（2）脑囊肿；（3）脑动脉瘤、脑血管瘤。我们对脑动脉瘤夹闭手术或栓塞手术和微创颅脑手术、脑垂体瘤、脑囊肿、脑动脉瘤及脑血管瘤、植入大脑内分流器四项中的其中一项承担保险责任，给付其中一项保险金后，对其他三项特定疾病保险责任同时终止。
16.植入大脑内分流器	指确实在脑室进行分流器植入手术，以缓解升高的脑脊液压力。必须由脑神经专科医生证实植入分流器为医疗所需。先天性脑积水不在保障范围内。我们对脑动脉瘤夹闭手术或栓塞手术和微创颅脑手术、脑垂体瘤、脑囊肿、脑动脉瘤及脑血管瘤、植入大脑内分流器四项中的其中一项承担保险责任，给付其中一项保险金后，对其他三项特定疾病保险责任同时终止。
17.重症头部外伤	指因头部遭受机械性外力伤害，引起脑重要部位损伤，并且由头颅X线断层扫描（CT）、核磁共振检查（MRI）或正电子发射断层扫描（PET）等影像学检查证实。头部外伤导致神经系统功能障碍，未达到本合同所指重大疾病严重脑损伤的给付标准，但是符合以下条件之一：（1）被保险人接受了全麻下颅骨切开颅内血肿清除术（颅骨钻孔术除外）；（2）在外伤180天后仍然遗留一肢或一肢以上肢体肌力II级或II级以下的运动功能障碍。我们对微创颅脑手术和重症头部外伤、硬脑膜下血肿手术三项中的其中一项承担保险责任，给付其中一项保险金后，对其他两项特定疾病保险责任同时终止。
18.硬脑膜下血肿手术	为清除或引流因意外导致的血肿，需于头部进行开颅或钻孔手术。开颅或钻孔手术必须在我们认可医院内由专科医生认为是医疗必须的情况下进行。我们对微创颅脑手术和重症头部外伤、硬脑膜下血肿手术三项中的其中一项承担保险责任，给付其中一项保险金后，对其他两项特定疾病保险责任同时终止。
19.中度重症肌无力	是一种神经与肌肉接头部位传递障碍的自身免疫性疾病，临床特征是局部或全身横纹肌于活动时易于疲劳无力，颅神经眼外肌最易累及，也可涉及呼吸肌、下肢近端肌群以至全身肌肉。该病必须由我们认可医院的专科医生明确诊断，且疾病确诊180天后，仍然存在自主生活能力部分丧失，无法独立完成六项基本日常生活活动中的两项，但未达到本合同所指重大疾病全身性（型）重症肌无力的标准。
20.视力严重受损三周	指因疾病或者意外伤害导致双眼视力永久不可逆性丧失，虽然未达到本太平福禄康瑞2018终身重大疾病保险，第13页，共31页岁始理赔合同所指重大疾病双目失明三周岁始理赔的给付标准，但满足下列条件之一：（1）双眼中较好眼矫正视力低于0.1（采用国际标准视力表，如果使用其他视力表应进行换算）；（2）双眼中较好眼视野半径小于20度。被保险人申请理赔时年龄必须在三周岁以上，并且提供理赔当时的视力丧失诊断及检查证据。我们对视力严重受损、单目失明和角膜移植三项中的其中一项承担保险责任，给付其中一项保险金后，对其它两项特定疾病保险责任同时终止。
21.单目失明三周岁始	指因疾病或意外伤害导致单眼视力永久不可逆性丧失，但未达到本合同理赔所指重大疾病双目失明三周岁始理赔或失去一肢及一眼的给付标准，患眼须满足下列至少一项条件：（1）眼球缺失或摘除；（2）矫正视力低于0.02（采用国际标准视力表，如果使用其它视力表应进行换算）；（3）视野半径小于5度。诊断须在我们认可的医院内由眼科专科医生确认，并且提供理赔当时的视力丧失诊断及检查证据。被保险人申请理赔时年龄必须在三周岁以上，并且提供理赔当时的视力丧失诊断及检查证据。我们对视力严重受损、单目失明和角膜移植三项中的其中一项承担保险责任，给付其中一项保险金后，对其它两项特定疾病保险责任同时终止。
22.角膜移植	指为增进视力或治疗某些角膜疾患，已经实施了异体的角膜移植手术。此手术必须在我们认可医院内由专科医生认为是医疗必须的情况下进行。我们对视力严重受损、单目失明和角膜移植三项中的其中一项承担保险责任，给付其中一项保险金后，对其它两项特定疾病保险责任同时终止。
23.肾脏切除	因疾病或者意外伤害导致至少单侧肾切除。因捐赠肾脏、恶性肿瘤而所需的肾脏切除不在保障范围内。
24.系统性红斑狼疮	必须符合下列所有理赔条件，但未达到本合同所指重大疾病系统性红斑狼疮（并发）III型或以上狼疮性肾炎诊断标准：（1）在下列5项情况中出现最少2项：关节炎：非磨损性关节炎，需涉及两个或以上关节；浆膜炎：胸膜炎或心包炎；肾病：24小时尿蛋白定量达到0.5克，或尿液检查出现细胞管型；血液学异常：溶血性贫血、白细胞减少、或血小板减少；抗核抗体阳性、或抗dsDNA阳性，或抗Smith抗体阳性。（2）系统性红斑狼疮的诊断必须由我们认可医院的风湿科或免疫系统专科医生确定。
25.糖尿病导致单足截除	因糖尿病引起的神经及血管病变累及足部，为了维持生命在我们认可医太平福禄康瑞2018终身重大疾病保险，第14页，共31页院内已经进行了医疗必须的由足踝或以上位置的单足截除手术。切除多只脚趾或因任何其他原因引起的截除术不在保障范围内。
26.单个肢体缺失	指一个肢体自腕关节或踝关节近端（靠近躯干端）以上完全性断离，但未达到本合同所指重大疾病多个肢体缺失或失去一肢及一眼的标准。因糖尿病导致单足截除导致的单个肢体缺失不在保障范围内。
27.单侧肺脏切除	因疾病或意外事故实际实施的一侧肺脏切除术。部分切除手术、肺脏捐献、因恶性肿瘤引起的手术不在保障范围内。
28.腔静脉过滤器植入术	为治疗反复肺栓塞发作，抗凝血疗法无效，已经实施了腔静脉过滤器植入术。手术必须在专科医生认为是医学上必需的情况下进行。
29.双侧睾丸切除术	指因疾病或者意外伤害导致接受了经腹部切开或腹腔镜进行的双侧睾丸完全切除手术。单侧或部分睾丸切除、变性手术、因恶性肿瘤引起的手术不在保障范围。
30.双侧卵巢切除术	指因疾病或者意外伤害导致接受了经腹部切开或腹腔镜进行的双侧卵巢完全切除手术。单侧或部分卵巢切除、变性手术、因恶性肿瘤引起的手术不在保障范围。
31.慢性肾功能衰竭	指被保险人因双肾功能慢性不可逆性损害达到肾功能衰竭期，但未达到本合同所指重大疾病终末期肾病（或称慢性肾功能衰竭尿毒症期）的标准。诊断必须满足所有以下标准。（1）GFR25；（2）Scr5mg/dl或442umol/L；（3）持续180天。
32.急性肾衰竭肾脏透析	急性肾衰竭（ARF）是指各种病因引起的肾功能在短期内（数小时或数治疗周）急剧进行性下降，导致体内氮质产物潴留而出现的临床综合征，国际上近年来改称为急性肾损伤（AKI），但未达到本合同所指重大疾病终末期肾病（或称慢性肾功能衰竭尿毒症期）的标准，被保险人被明确诊断为急性肾衰竭并且满足下列所有条件：（1）少尿或无尿2天以上；（2）血肌酐（Scr）5mg/dl或442umol/L；（3）血钾6.5mmol/L；（4）接受了血液透析治疗。
33.急性出血坏死性胰腺	指被保险人被确诊为急性坏死性胰腺炎，并实际接受了腹腔镜手术治疗，炎腹腔镜手术以进行坏死组织清除、坏死病灶切除或胰腺切除。因酗酒或饮酒过量所致的急性坏死性胰腺炎不在保障范围内。
34.早期肝硬化	肝硬化须由专科医生明确诊断。必须由活检证实有再生的肝细胞结节和典型的肝组织纤维化。下列条件必须全部满足并至少持续一年：（1）持续性黄疸，胆红素水平升高超过50umol/L;（2）蛋白质合成异常，白蛋白水平低于27g/L;（3）异常凝血功能，凝血酶原时间超过正常上限的2倍或以上，或者国际正常化比率（INR）在2.0以上。因酗酒或药物滥用导致的肝功能衰竭不在保障范围内。
35.急性重型肝炎人工肝	被保险人被明确诊断为急性重型肝炎，并且实际接受了人工肝支持系统治疗（ALSS）治疗。ALSS又称体外肝脏支持装置，指借助体外机械、化学或生物性装置暂时太平福禄康瑞2018终身重大疾病保险，第15页，共31页部分替代肝脏功能，协助治疗肝脏功能不全或相关疾病的治疗方法。慢性重型肝炎ALSS治疗不在保障范围内。
36.中度瘫痪	指因疾病或者意外伤害导致一肢或一肢以上肢体机能永久完全丧失，且未达到本合同所指重大疾病瘫痪的给付标准。肢体机能永久完全丧失，指疾病确诊180天后或意外伤害发生180天后，每肢三大关节中的两大关节仍然完全僵硬，或不能随意识活动。
37.中度昏迷	指因疾病或意外伤害导致意识丧失，对外界刺激和体内需求均无反应，昏迷程度按照格拉斯哥昏迷分级（Glasgowcomascale）结果为5分或5分以下，且已经持续使用呼吸机及其他生命维持系统达到48小时，但未达到本合同所指重大疾病深度昏迷的标准。因酗酒或药物滥用导致的深度昏迷不在保障范围内。
38.单耳失聪	指因疾病或者意外伤害导致单耳听力永久不可逆性丧失，未达到本合同所指重大疾病双耳失聪三周岁始理赔的给付标准，但满足以下条件：在500赫兹、1000赫兹和2000赫兹语音频率下，平均听阈大于90分贝，且经纯音听力测试、声导抗检测或者听觉诱发电位检测等证实。被保险人在三周岁之前因疾病导致的单耳失聪不在保障范围内。我们对单耳失聪、听力严重受损和人工耳蜗植入术三项中的其中一项承担保险责任，给付其中一项保险金后，对其它两项特定疾病保险责任同时终止。
39.听力严重受损三周	指因疾病或意外伤害导致双耳听力永久不可逆性丧失，在500赫兹、1000岁始理赔赫兹和2000赫兹语音频率下，平均听阈大于70分贝，但未超过90分贝，且经纯音听力测试、声导抗检测或听觉诱发电位检测等证实。被保险人申请理赔时年龄必须在三周岁以上，并且提供理赔当时的听力丧失诊断及检查证据。我们对单耳失聪、听力严重受损和人工耳蜗植入术三项中的其中一项承担保险责任，给付其中一项保险金后，对其它两项特定疾病保险责任同时终止。
40.人工耳蜗植入术	指由于耳蜗的永久损害而实际实施了人工耳蜗植入手术。诊断须经专科医生确认在医学上是必要的，且在植入手术之前已经符合下列全部条件：（1）双耳持续12个月以上重度感音神经性耳聋；（2）使用相应的听力辅助设备效果不佳。我们对单耳失聪、听力严重受损和人工耳蜗植入术三项中的其中一项承担保险责任，给付其中一项保险金后，对其它两项特定疾病保险责任同时终止。
41.全身较小面积度烧	指烧伤程度为度，且度烧伤面积为全身体表面积的10或者10以伤上，但尚未达到20。体表面积根据中国新九分法计算。若被保险人因同一原因导致其同时满足全身较小面积度烧伤、轻度面部烧伤的，仅按其中一项给付。
42.轻度面部烧伤	指烧伤程度为度，且度烧伤的面积达到面部表面积的30或者30以上，但未达到面部表面积的80。若被保险人因同一原因导致其同时满足全身较小面积度烧伤、轻度面部烧伤的，仅按其中一项给付。
43.面部重建手术	因疾病或意外事故导致的需要整形或者重建手术（颈部以上的面部构造不完整、缺失或者受损而对其形态及外观进行修复或者重建），同时必须太平福禄康瑞2018终身重大疾病保险，第16页，共31页由专科医生认为该面部毁容是需要接受住院治疗，及其后接受该手术，而对该面部毁容所进行的治疗亦是医疗所需。因纯粹整容原因、独立的牙齿修复、独立的鼻骨骨折或者独立的皮肤伤口所进行的手术均受此保障。若被保险人因同一原因导致其同时满足面部重建手术、轻度面部烧伤的，仅按其中一项给付。
44.中度类风湿性关节炎	根据美国风湿病学院的诊断标准，由风湿科专科医生明确诊断并符合下列所有理赔条件，但未达到本合同所指重大疾病严重类风湿性关节炎或严重幼年型类风湿性关节炎的标准：（1）关节广泛受损，并经临床证实出现最少2个下列关节位置严重变形：手部、手腕、肘部、膝部、髋部、踝部、颈椎或脚部；（2）至少180天无法独立完成六项基本日常生活活动中的两项或两项以上。
45.坏死性筋膜炎组织肌	是一种由细菌侵入皮下组织和筋膜引起的急性坏死性软组织感染，可伴肉切除术有毒血症、败血症、中毒性休克、弥漫性血管内凝血及多器官衰竭，但未达到本合同所指重大疾病重症急性坏死性筋膜炎标准，必须满足下列所有条件：（1）细菌培养和临床表现符合坏死性筋膜炎诊断标准；（2）病情迅速恶化，有脓毒血症表现；（3）出现广泛肌肉及软组织坏死，实际接受了坏死组织、筋膜及肌肉的广泛切除手术。
46.骨质疏松骨折髋关节	骨质疏松是一种系统性疾病。其特征为骨质量减少，骨小梁数目减少、置换手术变细和骨皮质变薄，导致骨脆性增加，骨折危险增加。根据世界卫生组织（WHO）建议，骨密度（BMD）较正常成人骨密度平均值降低2.5个标准差为骨质疏松症。必须满足下列所有条件：（1）依照诊断标准确诊为骨质疏松症；（2）实际发生了股骨颈骨折并接受了髋关节置换手术。
47.中度脑炎或脑膜炎后	指因患脑炎或脑膜炎导致的神经系统的功能障碍。神经系统的功能障碍，遗症指疾病确诊180天后，仍存在自主活动能力完全丧失，无法独立完成六项基本日常生活活动中的两项。若被保险人已符合本合同所指的重大疾病脑炎后遗症或脑膜炎后遗症给付标准的，则不在保障范围内。
48.严重阻塞性睡眠窒息	须有相关医学范畴的注册专科医生，经多导睡眠监测仪监测明确诊断为症严重阻塞性睡眠呼吸暂停综合征（OSA），并必须符合以下两项条件：（1）被保险人必须现正接受持续气道正压呼吸器（CPAP）之夜间治疗；（2）必须提供睡眠测试的文件证明，显示AHI30及夜间血氧饱和平均值85。
49.肝叶切除	因疾病或者意外伤害导致至少一整叶肝脏切除。因酒精或者滥用药物引致的疾病或者紊乱及因捐赠肝脏、恶性肿瘤所需的肝脏手术均不在保障范围内。
50.可逆性再生障碍性贫	指因急性可逆性的骨髓造血功能衰竭而导致贫血、中性粒细胞减少和血血小板减少，必须由血液科医生的诊断，且病历资料显示接受了下列任一治疗：（1）骨髓刺激疗法至少一个月；（2）免疫抑制剂治疗至少一个月；太平福禄康瑞2018终身重大疾病保险，第17页，共31页（3）接受了骨髓移植。
第三十三条重大疾病的种类及定义	本合同所保障的重大疾病，是指被保险人经专科医生明确诊断初次发生下列疾病或初次达到下列疾病状态或在医院初次接受下列手术。本合同所保障的重大疾病共100种，其中125种为2007年4月3日启用的重大疾病保险的疾病定义使用规范中列明的重大疾病，该规范由中国保险行业协会制定，其他为我们增加的重大疾病。
1.恶性肿瘤	指恶性细胞不受控制的进行性增长和扩散，浸润和破坏周围正常组织，可以经血管、淋巴管和体腔扩散转移到身体其他部位的疾病。经病理学检查结果明确诊断，临床诊断属于世界卫生组织疾病和有关健康问题的国际统计分类（ICD10）的恶性肿瘤范畴。下列疾病不在保障范围内：（1）原位癌；（2）相当于Binet分期方案A期程度的慢性淋巴细胞白血病；（3）相当于AnnArbor分期方案I期程度的何杰金氏病；（4）皮肤癌（不包括恶性黑色素瘤及已发生转移的皮肤癌）；（5）TNM分期为T1N0M0期或更轻分期的前列腺癌（注：如果为女性重大疾病保险，则不包括此项）；（6）感染艾滋病病毒或患艾滋病期间所患恶性肿瘤。
2.急性心肌梗塞	指因冠状动脉阻塞导致的相应区域供血不足造成部分心肌坏死。须满足下列至少三项条件：（1）典型临床表现，例如急性胸痛等；（2）新近的心电图改变提示急性心肌梗塞；（3）心肌酶或肌钙蛋白有诊断意义的升高，或呈符合急性心肌梗塞的动态性变化；（4）发病90天后，经检查证实左心室功能降低，如左心室射血分数低于50。
3.脑中风后遗症	指因脑血管的突发病变引起脑血管出血、栓塞或梗塞，并导致神经系统永久性的功能障碍。神经系统永久性的功能障碍，指疾病确诊180天后，仍遗留下列一种或一种以上障碍：（1）一肢或一肢以上肢体机能完全丧失28；（2）语言能力或咀嚼吞咽能力完全丧失29；（3）自主生活能力完全丧失，无法独立完成六项基本日常生活活动中的三项或三项以上。
4.重大器官移植术或造血干	重大器官移植术，指因相应器官功能衰竭，已经实施了肾脏、肝脏、心细胞移植术脏或肺脏的异体移植手术。造血干细胞移植术，指因造血功能损害或造血系统恶性肿瘤，已经实施了造血干细胞（包括骨髓造血干细胞、外周血造血干细胞和脐血造血干28肢体机能完全丧失：指肢体的三大关节中的两大关节僵硬，或不能随意识活动。肢体是指包括肩关节的整个上肢或包括髋关节的整个下肢。29语言能力或咀嚼吞咽能力完全丧失：语言能力完全丧失，指无法发出四种语音（包括口唇音、齿舌音、口盖音和喉头音）中的任何三种、或声带全部切除，或因大脑语言中枢受伤害而患失语症。咀嚼吞咽能力完全丧失，指因牙齿以外的原因导致器质障碍或机能障碍，以致不能作咀嚼吞咽运动，除流质食物外不能摄取或吞咽的状态。太平福禄康瑞2018终身重大疾病保险，第18页，共31页细胞）的异体移植手术。
5.冠状动脉搭桥术（或称冠状	指为治疗严重的冠心病，实际实施了开胸进行的冠状动脉血管旁路移植动脉旁路移植术）的手术。冠状动脉支架植入术、心导管球囊扩张术、激光射频技术及其他非开胸的介入手术、腔镜手术不在保障范围内。
6.终末期肾病（或称慢性肾功	指双肾功能慢性不可逆性衰竭，达到尿毒症期，经诊断后已经进行了至能衰竭尿毒症期）少90天的规律性透析治疗或实施了肾脏移植手术。
7.多个肢体缺失	指因疾病或意外伤害导致两个或两个以上肢体自腕关节或踝关节近端（靠近躯干端）以上完全性断离。
8.急性或亚急性重症肝炎	指因肝炎病毒感染引起肝脏组织弥漫性坏死，导致急性肝功能衰竭，且经血清学或病毒学检查证实，并须满足下列全部条件：（1）重度黄疸或黄疸迅速加重；（2）肝性脑病；（3）B超或其他影像学检查显示肝脏体积急速萎缩；（4）肝功能指标进行性恶化。
9.良性脑肿瘤	指脑的良性肿瘤，已经引起颅内压增高，临床表现为视神经乳头水肿、精神症状、癫痫及运动感觉障碍等，并危及生命。须由头颅X线断层扫描（CT）、核磁共振检查（MRI）或正电子发射断层扫描（PET）等影像学检查证实，并须满足下列至少一项条件：（1）实际实施了开颅进行的脑肿瘤完全切除或部分切除的手术；（2）实际实施了对脑肿瘤进行的放射治疗。脑垂体瘤、脑囊肿、脑血管性疾病不在保障范围内。
10.慢性肝功能衰竭失代偿期	指因慢性肝脏疾病导致肝功能衰竭。须满足下列全部条件：（1）持续性黄疸；（2）腹水；（3）肝性脑病；（4）充血性脾肿大伴脾功能亢进或食管胃底静脉曲张。因酗酒或药物滥用导致的肝功能衰竭不在保障范围内。
11.脑炎后遗症或脑膜炎后遗	指因患脑炎或脑膜炎导致的神经系统永久性的功能障碍。神经系统永久症性的功能障碍，指疾病确诊180天后，仍遗留下列一种或一种以上障碍：（1）一肢或一肢以上肢体机能完全丧失；（2）语言能力或咀嚼吞咽能力完全丧失；（3）自主生活能力完全丧失，无法独立完成六项基本日常生活活动中的三项或三项以上。
12.深度昏迷	指因疾病或意外伤害导致意识丧失，对外界刺激和体内需求均无反应，昏迷程度按照格拉斯哥昏迷分级（Glasgowcomascale）结果为5分或5分以下，且已经持续使用呼吸机及其他生命维持系统96小时以上。因酗酒或药物滥用导致的深度昏迷不在保障范围内。
13.双耳失聪三周岁始理赔	指因疾病或意外伤害导致双耳听力永久不可逆性丧失，在500赫兹、1000赫兹和2000赫兹语音频率下，平均听阈大于90分贝，且经纯音听力测试、声导抗检测或听觉诱发电位检测等证实。被保险人申请理赔时年龄必须在三周岁以上，并且提供理赔当时的听力丧失诊断及检查证据。
14.双目失明三周岁始理赔	指因疾病或意外伤害导致双眼视力永久不可逆性丧失，双眼中较好眼须太平福禄康瑞2018终身重大疾病保险，第19页，共31页满足下列至少一项条件：（1）眼球缺失或摘除；（2）矫正视力低于0.02（采用国际标准视力表，如果使用其他视力表应进行换算）；（3）视野半径小于5度。被保险人申请理赔时年龄必须在三周岁以上，并且提供理赔当时的视力丧失诊断及检查证据。
15.瘫痪	指因疾病或意外伤害导致两肢或两肢以上肢体机能永久完全丧失。肢体机能永久完全丧失，指疾病确诊180天后或意外伤害发生180天后，每肢三大关节中的两大关节仍然完全僵硬，或不能随意识活动。
16.心脏瓣膜手术	指为治疗心脏瓣膜疾病，实际实施了开胸进行的心脏瓣膜置换或修复的手术。
17.严重阿尔茨海默病	指因大脑进行性、不可逆性改变导致智能严重衰退或丧失，临床表现为明显的认知能力障碍、行为异常和社交能力减退，其日常生活必须持续受到他人监护。须由头颅X线断层扫描（CT）、核磁共振检查（MRI）或正电子发射断层扫描（PET）等影像学检查证实，且自主生活能力完全丧失，无法独立完成六项基本日常生活活动中的三项或三项以上。神经官能症和精神疾病不在保障范围内。
18.严重脑损伤	指因头部遭受机械性外力，引起脑重要部位损伤，导致神经系统永久性的功能障碍。须由头颅X线断层扫描（CT）、核磁共振检查（MRI）或正电子发射断层扫描（PET）等影像学检查证实。神经系统永久性的功能障碍，指脑损伤180天后，仍遗留下列一种或一种以上障碍：（1）一肢或一肢以上肢体机能完全丧失；（2）语言能力或咀嚼吞咽能力完全丧失；（3）自主生活能力完全丧失，无法独立完成六项基本日常生活活动中的三项或三项以上。
19.严重帕金森病	是一种中枢神经系统的退行性疾病，临床表现为震颤麻痹、共济失调等。须满足下列全部条件：（1）药物治疗无法控制病情；（2）自主生活能力完全丧失，无法独立完成六项基本日常生活活动中的三项或三项以上。继发性帕金森综合征不在保障范围内。
20.严重度烧伤	指烧伤程度为度，且度烧伤的面积达到全身体表面积的20或20以上。体表面积根据中国新九分法计算。
21.严重原发性肺动脉高压	指不明原因的肺动脉压力持续性增高，进行性发展而导致的慢性疾病，已经造成永久不可逆性的体力活动能力受限，达到美国纽约心脏病学会心功能状态分级IV级，且静息状态下肺动脉平均压超过30mmHg。
22.严重运动神经元病	是一组中枢神经系统运动神经元的进行性变性疾病，包括进行性脊肌萎缩症、进行性延髓麻痹症、原发性侧索硬化症、肌萎缩性侧索硬化症。须满足自主生活能力完全丧失，无法独立完成六项基本日常生活活动中的三项或三项以上的条件。我们承担本项疾病责任不受本合同责任免除中遗传性疾病，先天性畸形、变形或染色体异常的限制。
23.语言能力丧失三周岁始	指因疾病或意外伤害导致完全丧失语言能力，经过积极治疗至少12个月太平福禄康瑞2018终身重大疾病保险，第20页，共31页理赔（声带完全切除不受此时间限制），仍无法通过现有医疗手段恢复。精神心理因素所致的语言能力丧失不在保障范围内。被保险人申请理赔时年龄必须在三周岁以上，并且提供理赔当时的语言能力丧失诊断及检查证据。
24.重型再生障碍性贫血	指因骨髓造血功能慢性持续性衰竭导致的贫血、中性粒细胞减少及血小板减少。须满足下列全部条件：（1）骨髓穿刺检查或骨髓活检结果支持诊断；（2）外周血象须具备以下三项条件：中性粒细胞绝对值0.5109/L；网织红细胞1；血小板绝对值20109/L。
25.主动脉手术	指为治疗主动脉疾病，实际实施了开胸或开腹进行的切除、置换、修补病损主动脉血管的手术。主动脉指胸主动脉和腹主动脉，不包括胸主动脉和腹主动脉的分支血管。动脉内血管成形术不在保障范围内。
26.严重多发性硬化	多发性硬化为中枢神经系统白质多灶性脱髓鞘病变，病变有时累及灰质。多发性硬化须由核磁共振检查（MRI）等影像学检查证实，经三级医院神经科专科医生明确诊断，并且已经造成永久不可逆的神经系统功能损害。永久不可逆神经系统功能损害指被保险人持续180天无法独立完成下列基本日常生活活动：（1）移动：自己从一个房间移动到另一个房间；或者（2）进食：自己从已准备好的碗或碟中取食物放入口中。
27.因职业关系导致的HIV感	被保险人在其常规职业工作过程中遭遇外伤，或者职业需要处理血液或染者其他体液时感染上人类免疫缺陷病毒（HIV）。理赔必须符合下列所有条件：（1）感染必须是在被保险人正在从事其职业工作中发生，该职业必须属于以下列表内的职业：（2）必须提供被保险人在所报事故发生后的5天以内进行的检查报告，该报告必须显示被保险人血液HIV病毒阴性和/或HIV抗体阴性；（3）必须在事故发生后的6个月内证实被保险人体内存在HIV病毒或者HIV抗体，即血液HIV病毒阳性和/或HIV抗体阳性。我们承担本项疾病责任不受本合同责任免除中被保险人感染艾滋病病毒或患艾滋病的限制。
28.特发性慢性肾上腺皮质功	指自身免疫性肾上腺炎（既往称：特发性肾上腺皮质萎缩）导致肾上腺能减退萎缩和慢性肾上腺皮质功能减退。必须满足所有以下条件：（1）明确诊断，符合所有以下诊断标准；血浆促肾上腺皮质激素(ACTH)水平测定大于100pg/ml；血浆和尿游离皮质醇及尿17羟皮质类固醇、17酮皮质类固醇测定、血浆肾素活性、血管紧张素II和醛固酮测定，显示为原发性肾上腺太平福禄康瑞2018终身重大疾病保险，第21页，共31页皮质功能减退症；血浆促肾上腺皮质激素(ACTH)刺激试验显示为原发性肾上腺皮质功能减退症。（2）已经采用皮质类固醇替代治疗180天以上。肾上腺结核、HIV感染或艾滋病感染、肿瘤所致的原发性肾上腺皮质功能减退和继发性肾上腺皮质功能减退不在保障范围内。
29.严重冠状动脉粥样硬化性	指经心脏科专科医生根据冠状动脉造影检查结果确诊为主要血管严重狭心脏病窄性病变，须满足下列至少一项条件：（1）左冠状动脉主干和右冠状动脉中，一支血管管腔堵塞75以上，另一支血管管腔堵塞60以上；（2）前降支、回旋支和右冠状动脉中，至少一支血管管腔堵塞75以上，其他两支血管管腔堵塞60以上。前降支的分支血管、左旋支的分支血管及右冠状动脉的分支血管的狭窄不作为本保障的衡量指标。
30.脊髓灰质炎	指由于脊髓灰质炎病毒感染所致的瘫痪性疾病，临床表现为运动功能损害或呼吸无力。脊髓灰质炎必须明确诊断。本合同仅对脊髓灰质炎造成的神经系统功能损害导致被保险人一肢或一肢以上肢体机能永久完全丧失的情况予以理赔。肢体机能永久完全丧失，指疾病确诊180天后，每肢三大关节中的两大关节仍然完全僵硬，或不能随意识活动。
31.全身性（型）重症肌无力	重症肌无力是一种神经肌肉接头传递障碍所致的疾病，表现为局部或全身骨骼肌（特别是眼外肌）极易疲劳。疾病可以累及呼吸肌、上肢或下肢的近端肌群或全身肌肉，必须满足下列全部条件：（1）经药物治疗和胸腺切除治疗一年以上仍无法控制病情；（2）自主生活能力完全丧失，无法独立完成六项基本日常生活活动中的三项或三项以上。
32.原发性心肌病	指因原发性心肌病导致慢性心功能损害造成永久不可逆性的心功能衰竭。心功能衰竭程度达到纽约心脏病学会心功能分级状态分级IV级。被保险人永久不可逆性的体力活动能力受限，不能从事任何体力活动。
33.严重克罗恩病（Crohns病）	克罗恩病是一种慢性肉芽肿性肠炎，具有特征性的克罗恩病病理组织学变化。诊断必须由病理检查结果证实。被保险人所患的克罗恩病必须已经造成瘘管形成并伴有肠梗阻或肠穿孔。
34.严重溃疡性结肠炎	本合同所保障的溃疡性结肠炎是指伴有致命性电解质紊乱的急性暴发性溃疡性结肠炎，病变累及全结肠，表现为严重的血便和系统性症状体征。溃疡性结肠炎必须根据组织病理学特点诊断，并且被保险人已经接受了结肠切除或回肠造瘘术。
35.植物人状态	是指由脑外伤、缺氧持续状态、严重的脑炎或者某种神经毒素造成大脑皮层广泛性损害，而脑干功能相对保留所致的一种丧失生理、意识和交流功能后的临床状态，并且该状态已持续30天以上。患者无法从事主动或者有目的的活动，但保留了躯体生存的基本功能，如新陈代谢、生长发育等。
36.严重1型糖尿病	指由于胰岛素分泌绝对不足引起严重胰岛素缺乏导致慢性血糖升高，需要依赖外源性胰岛素进行机体的葡萄糖代谢和维持生命。被保险人的1型糖尿病必须诊断明确，而且有血胰岛素测定及血C肽或尿C肽测定结果支持诊断，并且已经持续性地接受外源性胰岛素注射治疗连续180天以上。太平福禄康瑞2018终身重大疾病保险，第22页，共31页
37.系统性红斑狼疮（并发）	系统性红斑狼疮是由多种因素引起，累及多系统的自身免疫性疾病。其III型或以上狼疮性肾炎特点是生成自身抗体对抗多种自身抗原。多见于育龄妇女。本合同所指的系统性红斑狼疮仅限于累及肾脏（经肾脏活检确认的，符合WHO诊断标准定义III型或III型以上狼疮性肾炎）的系统性红斑狼疮。其他类型的红斑性狼疮，如盘状狼疮、仅累及血液及关节的狼疮不在保障范围取Ｊ澜缥郎组织（WHO）狼疮性肾炎分型：
38.非阿尔茨海默病所致严重	指因阿尔茨海默病以外的脑的器质性疾病造成脑功能衰竭导致永久不可痴呆逆性的严重痴呆，临床表现为明显的认知能力障碍、行为异常和社交能力减退。被保险人自主生活能力完全丧失，无法独立完成六项基本日常生活活动中的三项或三项以上，日常生活必须持续受到他人监护。导致痴呆的疾病必须明确诊断，并且有完整的临床、实验室和影像学检查结果证实。神经官能症,精神疾病及酒精中毒所致脑损害不在保障范围内。
39.严重类风湿性关节炎	指广泛分布的慢性进行性多关节病变，表现为关节严重变形，侵犯至少三个主要关节（腕关节、肘关节、肩关节、踝关节、膝关节、髋关节）或关节组（如手的多个指间、掌指关节，足的多个足趾、跖趾关节等）。类风湿性关节炎须明确诊断，并已达到类风湿性关节炎功能活动分级（注）III级的永久不可逆性关节功能障碍，且须满足下列全部条件：（1）晨僵；（2）对称性关节炎；（3）类风湿性皮下结节；（4）类风湿因子滴度升高；（5）X线显示严重的关节（软骨和骨）破坏和关节畸形。注：类风湿性关节炎功能活动分级：级：关节功能完整，一般活动无障碍。级：有关节不适或障碍，但尚能完成一半活动。级：功能活动明显受限，但大部分生活可自理。级：生活不能自理或卧床。
40.严重哮喘二十五周岁前	指一种反复发作的严重支气管阻塞性疾病，经我们认可的专科医生确诊，理赔且必须同时符合下列标准：（1）过去两年中曾因哮喘持续状态住院治疗，并提供完整住院记录；（2）因慢性过度换气导致胸廓畸形；（3）在家中需要医生处方的氧气治疗法；（4）持续日常服用口服类固醇激素治疗持续至少六个月。被保险人申请理赔时年龄必须在年满二十五周岁之前。
41.肾髓质囊性病	肾髓质囊性病的诊断须同时符合下列要求：（1）肾髓质有囊肿、肾小管萎缩及间质纤维化等病理改变；太平福禄康瑞2018终身重大疾病保险，第23页，共31页（2）肾功能衰竭；（3）诊断须由肾组织活检确定。我们承担本项疾病责任不受本合同责任免除中遗传性疾病，先天性畸形、变形或染色体异常的限制。
42.重症急性坏死性筋膜炎	是一种由细菌侵入皮下组织和筋膜引起的急性坏死性软组织感染，可伴有毒血症、败血症、中毒性休克、弥漫性血管内凝血及多器官衰竭。必须满足以下所有条件：（1）细菌培养和临床表现符合坏死性筋膜炎诊断标准；（2）病情迅速恶化，有脓毒血症表现；（3）受感染肢体被截肢（自腕关节或踝关节近端）。
43.慢性呼吸功能衰竭终末期	指经专科医生明确诊断，且被保险人已出现慢性呼吸功能衰竭，其诊断肺病标准必须满足下列所有条件：（1）肺功能测试其FEV1持续低于1升；（2）动脉血气分析氧分压低于55mmHg；（3）病人缺氧必须进行输氧治疗。
44.胰腺移植	指因胰腺功能衰竭，已经实施了在全身麻醉下进行的胰腺的异体器官移植手术（供体必须是人体器官）。单纯胰岛移植、部分胰腺组织或细胞的移植不在保障范围内。
45.埃博拉病毒感染	指受埃博拉病毒感染导致出血性发热。埃博拉病必须经国家机关认可的有合法资质的传染病专家确诊，并且埃博拉病毒的存在必须经过实验室检查证实。该病必须从症状开始后30天后持续出现并发症。
46.破裂脑动脉瘤夹闭手术	指因脑动脉瘤破裂造成蛛网膜下腔出血，被保险人实际接受了在全麻下进行的开颅动脉瘤夹闭手术。脑动脉瘤（未破裂）预防性手术、颅骨打孔手术、动脉瘤栓塞手术、血管内手术及其他颅脑手术不在保障范围内。
47.丝虫病所致象皮肿	指因丝虫感染导致淋巴阻塞性出现严重淋巴水肿，达到国际淋巴学会淋巴水肿分期第III期，临床表现为肢体象皮肿，患肢较健肢增粗30以上，日常生活不能自理。
48.急性坏死性胰腺炎开腹手	指为治疗急性坏死性胰腺炎，实际实施了开腹进行的坏死组织清除术、术病灶切除术或胰腺部分切除术。为治疗因酒精中毒引起的急性坏死性胰腺炎的开腹手术不在保障范围内。
49.主动脉夹层血肿	是指主动脉壁在受到某些病理因素的破坏后，高速、高压的主动脉血流将其内膜撕裂，以致主动脉腔内的血流通过主动脉内膜的破裂口进入主动脉内壁而形成血肿。被保险人需通过断层扫描（CT）、核磁共振检查（MRI）、磁共振血管检验法（MRA）或血管扫描等检查，并且实施了胸腹切开的直视主动脉手术。
50.系统性硬皮病	指一种以局限性或弥漫性皮肤增厚和皮肤、血管、内脏器官异常纤维化为特征的结缔组织病。本病须经专科医生明确诊断，并须满足下列至少一项条件：（1）肺脏：肺部病变进而发展为肺间质纤维化和肺动脉高压；（2）心脏：心功能受损达到美国纽约心脏病学会心功能状态分级IV级；（3）肾脏：肾脏受损导致双肾功能慢性不可逆衰竭，达到尿毒症期。
51.原发性硬化性胆管炎	指一种胆汁淤积综合征，其特征是肝内、肝外胆道因纤维化性炎症逐渐太平福禄康瑞2018终身重大疾病保险，第24页，共31页狭窄，并最终导致完全阻塞而发展为肝硬化。本病须经内镜逆行胰胆管造影等影像学检查证实，并须满足下列全部条件：（1）总胆红素和直接胆红素同时升高，血清ALP200U/L；（2）持续性黄疸病史；（3）出现胆汁性肝硬化或门脉高压。因肿瘤或胆管损伤等继发性的硬化性胆管炎不在保障范围内。
52.经输血导致的HIV感染	指被保险人感染上人类免疫缺陷病毒（HIV）并且满足下列全部条件：（1）被保险人等待期后因输血而感染HIV；（2）提供输血治疗的输血中心或医院出具该项输血感染属医疗责任事故的报告，或者法院终审裁定为医疗责任并且不准上诉；（3）受感染的被保险人不是血友病患者。任何因其他传播方式（包括：性传播或静脉注射毒品）导致的HIV感染不在保障范围内。我们保留获得使用被保险人的所有血液样本的权利，并对这些样本进行独立检验。我们承担本项疾病责任不受本合同责任免除中被保险人感染艾滋病病毒或患艾滋病的限制。
53.疯牛病	一种由动物传染而来的中枢神经系统变性性疾病，大脑呈海绵状改变伴神经元缺失和胶质化。临床表现为进行性痴呆、不随意运动及抽搐、行动困难等等。疯牛病必须由权威医疗机构根据致病蛋白的发现而明确诊断。疑似诊断不作为理赔依据。
54.慢性复发性胰腺炎	指有腹痛等典型症状的胰腺炎反复发作，导致胰腺进行性破坏，并导致胰腺功能紊乱而导致严重糖尿病以及营养不良、恶液质。断层扫描（CT）证实胰腺存在广泛钙化，且必须接受酶替代以及胰岛素替代治疗6个月以上。诊断必须由消化科专科医生确诊。酒精导致的慢性复发性胰腺炎不在保障范围内。
55.神经白塞病	白塞病是一种慢性全身性血管炎症性疾病，主要表现为复发性口腔溃疡、生殖器溃疡、眼炎及皮肤损害，并可累及大血管、神经系统、消化道、肺、肾等等。累及神经系统损害的白塞病称为神经白塞病。神经白塞病必须明确诊断，并且已经造成永久不可逆的神经系统功能损害。须满足自主生活能力完全丧失，无法独立完成六项基本日常生活活动中的三项或三项以上的条件。
56.肺源性心脏病	指由于各种胸肺及支气管病变而继发的肺动脉高压，最后导致以右室肥大为特征的心脏病。须经呼吸专科医生确诊，且必须同时满足如下诊断标准：（1）左心房压力增高（不低于20个单位）；（2）肺血管阻力高于正常值3个单位（PulmonaryResistance）；（3）肺动脉血压不低于40毫米汞柱；（4）肺动脉楔压不低于6毫米汞柱；（5）右心室心脏舒张期末压力不低于8毫米汞柱；（6）右心室过度肥大、扩张，出现右心衰竭和呼吸困难。
57.严重肌营养不良症	指一组原发于肌肉的遗传性疾病，临床表现为与神经系统无关的肌肉无力和肌肉萎缩。且须满足下列全部条件：（1）肌肉组织活检结果满足肌营养不良症的肌肉细胞变性、坏死等阳性太平福禄康瑞2018终身重大疾病保险，第25页，共31页改变；（2）自主生活能力完全丧失，无法独立完成六项基本日常生活活动中的三项或三项以上。我们承担本项疾病责任不受本合同责任免除中遗传性疾病，先天性畸形、变形或染色体异常的限制。
58.严重川崎病	一种血管炎综合征，临床表现为急性发热，皮肤粘膜病损和淋巴结肿大。本病须经专科医生明确诊断，同时须由血管造影或者超声心动图检查证实，满足下列至少一项条件：（1）伴有冠状动脉瘤，且冠状动脉瘤于最初急性发病后持续至少180天；（2）伴有冠状动脉瘤，且实际接受了对冠状动脉瘤进行的手术治疗。
59.严重自身免疫性肝炎	自身免疫性肝炎是一种原因不明的慢性肝脏的坏死性炎性疾病，机体免疫机制被破坏，产生针对肝脏自身抗原的抗体导致自身免疫反应，从而破坏肝细胞造成肝脏炎症坏死，进而发展为肝硬化。必须满足所有以下条件：（1）高球蛋白血症；（2）血液中存在高水平的自身免疫抗体，如ANA（抗核抗体）、SMA（抗平滑肌抗体）、抗LKM1抗体或抗SLA/LP抗体；（3）肝脏活检证实免疫性肝炎；（4）临床已经出现腹水、食道静脉曲张和脾肿大等肝硬化表现。
60.严重心肌炎	心肌的严重感染而导致至少持续6个月的心功能损害。严重的心功能损害必须具备如下条件：左室腔扩大至少达到正常值上限的120，且左室射血分数持续性低于40。
61.严重面部烧伤	指面部烧伤程度为度，即全层皮肤烧伤，包括表皮、真皮和皮下组织，且度烧伤的面积达到面部表面积的80或者80以上。
62.肝豆状核变性（或称Wilson	指一种常染色体隐性遗传的铜代谢缺陷病，以不同程度的肝细胞损害、病）脑退行性病变和角膜边缘有铜盐沉着环为其临床特征，并须满足下列全部条件：（1）典型症状；（2）角膜色素环（KF环）；（3）血清铜和血清铜蓝蛋白降低，尿铜增加；（4）经皮做肝脏活检来定量分析肝脏铜的含量。我们承担本项疾病责任不受本合同责任免除中遗传性疾病，先天性畸形、变形或染色体异常的限制。
63.溶血性链球菌引起的坏疽	躯干或肢体的浅筋膜或涉及肌肉的深筋膜感染，呈暴发性进展，必须即刻手术清创。须在外科手术后进行组织培养证实溶血性链球菌坏疽并由专科医生确诊。
64.严重肠道疾病并发症	严重肠道疾病或外伤导致小肠损害并发症，满足以下所有条件：（1）至少切除了三分之二小肠；（2）完全肠外营养支持三个月以上。
65.严重瑞氏综合征（Reye综合	瑞氏综合征是线粒体功能障碍性疾病。导致脂肪代谢障碍，引起短链脂征，也称赖氏综合征、雷氏肪酸、血氨升高，造成脑水肿。主要临床表现为急性发热、反复呕吐、综合征）惊厥及意识障碍等等。肝脏活检是确诊的重要手段。瑞氏综合征需由三级医院的儿科专科医生确诊，并符合下列所有条件：太平福禄康瑞2018终身重大疾病保险，第26页，共31页（1）有脑水肿和颅内压升高的脑脊液检查和影像学检查证据；（2）血氨超过正常值的3倍；（3）临床出现昏迷，病程至少达到疾病分期第3期。
66.III型成骨不全症	骨生长不全症是一种胶原病，特征为骨易碎，骨质疏松和易骨折。该病有4种类型：I型、II型、III型、IV型。本保障范围仅涉及III型成骨不全症，其主要临床特点有：发展迟缓、多发性骨折、进行性脊柱后侧凸及听力损害。III型成骨不全的诊断必须根据身体检查，家族史，X线检查和皮肤活检报告资料确诊，并经专科医生出具诊断证明。我们承担本项疾病责任不受本合同责任免除中遗传性疾病，先天性畸形、变形或染色体异常的限制。
67.严重传染性心内膜炎	是指由感染性微生物引致的心脏内膜炎症，并须符合下所有条件：（1）血液培植结果呈阳性反应，证明感染性微生物的存在，导致传染性心内膜炎；（2）出现最少中度之心脏瓣膜功能全（即返流部分达百分之二十或以上）或中度之心脏瓣膜狭窄（即心脏瓣膜面积为正常值的百分之三十或以下）；（3）传染性心内膜炎的诊断及瓣膜受损的严重程度必须由心脏病专科医生出具相关证明。
68.失去一肢及一眼	因疾病或意外伤害导致单眼视力丧失及任何一肢自腕关节或踝关节近端（靠近躯干端）以上完全性断离。单眼视力丧失指单眼视力永久不可逆性丧失，患眼须满足下列至少一项条件：（1）眼球缺失或摘除；（2）矫正视力低于0.02（采用国际标准视力表，如果使用其他视力表应进行换算）；（3）视野半径小于5度。被保险人在三周岁之前因疾病导致单眼视力丧失不在保障范围内。
69.肺淋巴管肌瘤病	指一种弥漫性肺部疾病，主要病理改变为肺间质、支气管、血管和淋巴管内出现未成熟的平滑肌异常增生，同时需满足下列全部条件：（1）经组织病理学诊断；（2）CT显示双肺弥漫性囊性改变；（3）血气提示低氧血症，动脉血氧分压（PaO2）持续50mmHg。
70.肺泡蛋白质沉积症	指肺泡和细支气管腔内充满不可溶性富磷脂蛋白的疾病，胸部X线呈双肺弥漫性肺部磨玻璃影，病理学检查肺泡内充满有过碘酸雪夫（PAS）染色阳性的蛋白样物质，并且接受了肺灌洗治疗。
71.骨髓纤维化	指一种因纤维组织取代正常骨髓从而导致贫血、白血球及血小板含量过低及脾脏肿大的疾病。病况必须恶化至永久性及严重程度导致被保险人需最少每月进行输血。此病症须经专科医生明确诊断，并需提供骨髓穿刺检查诊断报告。
72.严重慢性缩窄型心包炎	指由于慢性心包炎症导致心包脏层和壁层广泛瘢痕粘连、增厚和钙化，心包腔闭塞，形成一个纤维瘢痕外壳，使心脏和大血管根部受压，妨碍心脏的舒张。必须经心脏专科医生明确诊断为慢性缩窄性心包炎，并且已经造成永久不可逆性的体力活动能力受限，达到美国纽约心脏病学会心功能状态分级级，且持续至少180天。被保险人永久不可逆性的体太平福禄康瑞2018终身重大疾病保险，第27页，共31页力活动能力受限，不能从事任何体力活动。
73.器官移植导致的HIV感染	指因进行器官移植而感染上人类免疫缺陷病毒（HIV），且须满足下列全部条件：（1）在保障起始日或复效日之后，被保险人因治疗必需而实施器官移植，并且因器官移植而感染人类免疫缺陷病毒；（2）提供器官移植治疗的器官移植中心或医院出具该项器官移植感染，属于医疗责任事故的报告，或者法院终审裁定为医疗责任并且不准上诉；（3）提供器官移植治疗的器官移植中心或医院必须拥有合法经营执照；任何因其他传播方式（包括：性传播或静脉注射毒品）导致的HIV感染不在保障范围内。我们承担本项疾病责任不受本合同责任免除中被保险人感染艾滋病病毒或患艾滋病的限制。
74.结核性脊髓炎	因结核杆菌引起的脊髓炎，导致永久性神经系统功能中度障碍，即：疾病首次确诊180天后，仍遗留下列一种或一种以上障碍：（1）一肢或一肢以上肢体肌力级或级以下的运动功能障碍；（2）自主生活能力部分丧失，无法独立完成六项基本日常生活活动中的两项或两项以上。该诊断必须由我们认可医院的神经专科医生证实，并必须由适当的检查证明为结核性脊髓炎。
75.肺孢子菌肺炎	指由肺孢子菌引起的间质性浆细胞性肺炎。并须满足下列全部条件：（1）第一秒末用力呼气量（FEV1）小于1升；（2）气道内阻力增加，至少达到0.5kPa/l/s；（3）残气容积占肺总量(TLC)的60以上；（4）胸内气体容积升高，超过170(基值的百分比)；（5）PaO260mmHg，PaCO250mmHg。感染艾滋病病毒或患艾滋病期间所患肺孢子菌肺炎不在保障范围内。
76.范可尼综合征	也称Fanconi综合征，指近端肾小管的功能异常引起的一组症候群。须经专科医生诊断，且须满足下列至少两项条件：（1）尿液检查出现肾性糖尿、全氨基酸糖尿或磷酸盐尿；（2）血液检查出现低磷血症、低尿酸血症或近端肾小管酸中毒；（3）出现骨质疏松、骨骼畸形或尿路结石；（4）通过骨髓片、白细胞、直肠黏膜中的结晶分析或裂隙灯检查角膜有胱氨酸结晶。被保险人在三周岁之前罹患该疾病，我们不承担保险责任。
77.弥漫性血管内凝血	指血液凝固系统和纤溶系统的过度活动导致微血管血栓形成、血小板及凝血因子耗竭和严重出血，需要输注血浆和浓缩血小板进行治疗。
78.严重III度冻伤导致截肢	冻伤是由于寒冷潮湿作用引起的人体局部或全身损伤。指冻伤程度达到III度，且导致一个或一个以上肢体自腕关节或踝关节近端（靠近躯干端）以上完全性断离。
79.大面积植皮手术	指为修复皮肤与其下的组织缺损所进行的皮肤移植手术，要求皮肤移植的面积达到全身体表面积的30或30以上。体表面积根据中国新九分法计算。
80.出血性登革热	严重登革热（出血性登革热），出现了全部四种症状，包括发高烧、出血现象、肝肿大和循环衰竭，符合登革热休克综合症标准，达到WHO登革太平福禄康瑞2018终身重大疾病保险，第28页，共31页热分级的第III级和第IV级。出血性登革热的诊断必须由我们认可医院的专科医生证实。非出血性登革热不在保障范围内。
81.重症手足口病	由肠道病毒引起的急性传染病，主要症状表现为手、足、口腔等部位的斑丘疹、疱疹。经我们认可的医疗机构的儿科专科医生确诊为患有手足口病，并伴有下列三项中的任意一项并发症：（1）有脑膜炎或脑炎并发症，且导致意识障碍或瘫痪的临床表现及实验室检查证据；（2）有肺炎或肺水肿并发症，且导致呼吸衰竭的临床表现及实验室检查证据；（3）有心肌炎并发症，且导致心脏扩大或心力衰竭的临床表现及实验室检查证据。
82.进行性核上性麻痹	进行性核上性麻痹（PSP）又称SteeleRchardsonOlszewski综合征，是一种少见的神经系统变性疾病，以假球麻痹、垂直性核上性眼肌麻痹、锥体外系肌僵直、步态共济失调和轻度痴呆为主要临床特征。PSP必须由三级甲等医院的神经内科专科医生确诊，并且被保险人自主生活能力完全丧失，无法独立完成六项基本日常生活活动中的三项或三项以上。
83.小肠移植	因疾病或意外事故导致严重小肠损害不得不切除三分之二以上肠段，为了维持生理功能的需要已经接受了小肠的同种（人类）异体器官移植手术，且此手术必须由专科医生认为是医学上必需的情况下进行。
84.肾上腺脑白质营养不良	指一种最常见的过氧化物酶体病，主要累及肾上腺和脑白质，主要表现为进行性的精神运动障碍，视力及听力下降和（或）肾上腺皮质功能低下等。须经专科医生诊断，且已经造成自主生活能力完全丧失，无法独立完成六项基本日常生活活动中的三项或三项以上，持续至少180天。被保险人在三周岁之前罹患该疾病，我们不承担保险责任。
85.皮质基底节变性	指一种慢性进展性神经变性疾病，以不对称发作的无动性强直综合征、失用、肌张力障碍及姿势异常为其临床特征。须经临床医生明确诊断，被保险人自主生活能力完全丧失，无法独立完成六项基本日常生活活动中的三项或三项以上，日常生活必须持续受到他人监护。
86.进行性多灶性白质脑病	指一种亚急性脱髓鞘性脑病，常常发现于免疫缺陷的病人。必须由神经科专科医生根据脑组织活检确诊。
87.进行性风疹性全脑炎	指由风疹病毒感染引起的儿童和青少年的慢性脑炎。疾病确诊180天后，仍遗留下列一种或一种以上障碍：（1）一肢或一肢以上肢体机能完全丧失；（2）语言能力或咀嚼吞咽能力完全丧失；（3）自主生活能力完全丧失，无法独立完成六项基本日常生活活动中的三项或三项以上。
88.Brugada综合征	由心脏科专科医生根据临床症状和典型心电图表现，明确诊断为Brugada综合征。经医生判断认为医疗必须安装且实际已安装永久性心脏除颤器。
89.异染性脑白质营养不良	指最常见的一种严重的神经退化性代谢病，是最常见的溶酶体病，主要三周岁始理赔表现为行走困难、智力低下、废用性肌萎缩、四肢痉挛性瘫痪、视神经萎缩、失语等。须经专科医生诊断，且已经造成自主生活能力完全丧失，无法独立完成六项基本日常生活活动中的三项或三项以上，持续至少180太平福禄康瑞2018终身重大疾病保险，第29页，共31页天。被保险人在三周岁之前罹患该疾病，我们不承担保险责任。
90.嗜铬细胞瘤	是指肾上腺或嗜铬外组织出现神经内分泌肿瘤，并分过多的儿茶酚胺类，需要确实进手术以切除肿瘤。嗜铬细胞瘤的诊断必须由内分泌专科医生确定。
91.自体造血干细胞移植手术	指因患者自身骨髓造血功能异常或为了达到治疗肿瘤的目的，采集患者自己的一部分造血干细胞，分离并深低温保存，再回输给患者使患者的造血功能和免疫功能重新恢复的自体移植手术。
92.疾病或外伤所致智力障碍	因严重头部创伤或疾病造成被保险人智力中度及以上低常（智力低于常态）。根据智商（IQ），智力低常分为轻度（IQ5070）、中度（IQ3550）、重度（IQ2035）和极重度（IQ20）。智力低常程度须达到中度及以上，即IQ50。智商的检测必须由我们认可的专职心理测验工作者进行，心理测验工作者必须持有心理测量专业委员会资格认定书。根据被保险人年龄采用对应的智力量表，如韦克斯勒智力量表（儿童智力量表或成人智力量表）。理赔时必须满足下列全部条件：（1）造成被保险人智力低常的严重头部创伤或疾病（以入院日期为准）发生在被保险人6周岁以后；（2）儿科专科医生确诊被保险人由于严重头部创伤或疾病造成智力低常；（3）专职合格心理检测工作者适时做的心理检测证实被保险人智力低常程度达到中度、重度或极重度，即IQ50；（4）被保险人的智力低常自确认日起持续180天以上。
93.严重幼年型类风湿性关节	幼年型类风湿关节炎是一种儿童期发病的慢性关节炎，其特点为在高热炎和系统性病征出现数月后发生关节炎。须满足下列全部条件：（1）因该病引致广泛性关节破坏，以致需要进髋及膝关节置换；（2）由风湿病专科医生确定诊断。
94.重症骨髓增生异常综合征	骨髓增生异常综合征是起源于造血干细胞的一组骨髓克隆增生异常的疾病，表现为无效造血、难治性血细胞减少，有转化为急性髓系白血病的风险。被保险人根据外周血和骨髓活检被专科医生明确诊断为骨髓增生异常综合征，并须满足下列全部条件：（1）FAB分类为难治性贫血伴原始细胞增多（RAEB）；（2）根据骨髓增生异常综合征修订国际预后积分系统（IPSSR）积分3.5，属于中危及以上组。
95.多处臂丛神经根性撕脱	由于疾病或意外导致至少两根臂丛神经根性撕脱，所造成的手臂感觉功能与运动功能完全永久性丧失。该病必须由我们认可的医院的专科医生确诊，并且有完整的电生理检查结果证实。
96.胆道重建术	因疾病或胆道损伤导致实际接受涉及胆总管小肠吻合术的胆道重建手术。诊断及治疗均须在我们认可的医院内由专科医生认为是医疗必须的情况下进行。因胆道闭锁等先天性疾病而导致进行的胆道手术并不在保障范围取
97.脊柱裂	指脊椎或颅骨不完全闭合，导致脊髓脊膜突出，脑（脊）膜突出或脑膨出，合并大小便失禁，部分或完全性下肢瘫痪或畸形等神经学上的异常，但不包括由X线摄片发现的没有合并脊椎脊膜突出或脑（脊）膜突出的太平福禄康瑞2018终身重大疾病保险，第30页，共31页隐形脊椎裂。我们承担本项疾病责任不受本合同责任免除中遗传性疾病，先天性畸形、变形或染色体异常的限制。
98.狂犬病	指狂犬病毒所致的急性传染病，人多因被病兽咬伤而感染。临床表现为特有的恐水、怕风、咽肌痉挛、进行性瘫痪等。须经专科医生明确诊断。
99.严重气性坏疽	指由梭状芽胞杆菌所致的肌坏死或肌炎。须经专科医生明确诊断，且须同时符合下列要求：（1）符合气性坏疽的一般临床表现；（2）细菌培养检出致病菌；（3）出现广泛性肌肉及组织坏死，并确实实施了坏死组织和筋膜以及肌肉的切除手术。清创术不在保障范围内。
100.破伤风	指破伤风梭菌经由皮肤或黏膜伤口侵入人体，在缺氧环境下生长繁殖，产生毒素而引起肌痉挛的一种特异性感染。须经专科医生明确诊断。本页内容结束太平福禄康瑞2018终身重大疾病保险，第31页，共31页
